id;code;canton;departement;cereales;racines_et_legumes_divers;cultures_diverses;prairies_artificielles;jacheres;total_des_terres_labourables;prairies_naturelles;vignes;autres_cultures_arborescentes;paturages;autres_surfaces_ecoumene;superficie_totale;marais_susceptibles_d_etre_desseches;code_departement;centre;geometry
1;291;BREST;FINISTERE;42516;9390;1284;4714;7681;65585;6922;0;271;48288;20377;141443;1952;29;;"list(list(c(173627.340242724, 152339.732441607, 146789.222569242, 150538.268792707, 135590.946553885, 124318.680014224, 128817.802349859, 159667.233661095, 165337.426013502, 173627.340242724, 6840498.66245154, 6816372.54428255, 6819286.0693785, 6836511.58342303, 6831460.83221542, 6841356.70759564, 6855071.22263635, 6866994.72964776, 6866754.7561989, 6840498.66245154)), list(c(131235.153385857, 129285.973076463, 136179.197363745, 131235.153385857, 6799742.31055929, 6801172.80120207, 6802366.68152851, 
6799742.31055929)))"
2;292;CHATEAULIN;FINISTERE;50750;3112;896;3029;15011;72798;12200;0;391;75120;22677;183186;4550;29;;list(c(173627.340242724, 216510.665816557, 217546.080404177, 216704.50652019, 199057.490851079, 151033.799832731, 159896.805491248, 158106.076281736, 152339.732441607, 173627.340242724, 6840498.66245154, 6817386.08270821, 6815209.40172717, 6812182.84416623, 6797308.56553438, 6804939.4423884, 6806474.48138435, 6813345.72550798, 6816372.54428255, 6840498.66245154))
3;294;QUIMPER;FINISTERE;39461;3579;1184;1849;12500;58573;8244;0;946;58953;13272;139988;1448;29;;list(c(136179.197363745, 151033.799832731, 199057.490851079, 185069.381327141, 178577.229553597, 168936.107282889, 162329.631850491, 151256.901845723, 146987.764494618, 131235.153385857, 136179.197363745, 6802366.68152851, 6804939.4423884, 6797308.56553438, 6769163.92931573, 6773488.36852903, 6775551.59420473, 6768594.59873292, 6774363.0073256, 6788181.57260101, 6799742.31055929, 6802366.68152851))
4;561;LORIENT;MORBIHAN;48668;4224;2119;238;2465;57714;13755;0;1720;60000;14183;147372;990;56;;list(c(232038.20772053, 249376.955985561, 240583.485148352, 239033.809392634, 237695.490725708, 224141.4334591, 216989.367749159, 213256.206424703, 232038.20772053, 6779634.77918271, 6763704.23180291, 6734084.6547795, 6733697.86970985, 6740973.51739493, 6753553.95845383, 6752562.66281898, 6761640.33121857, 6779634.77918271))
5;641;BAYONNE;BASSES PYRENEES;19226;835;1039;525;1017;22642;8125;2401;2521;42500;25260;103449;30;64;;list(c(366664.007018827, 366513.107179435, 338399.128791859, 338013.103883292, 344068.465298726, 315806.387637966, 334595.766512512, 342353.137292983, 343612.807841696, 366664.007018827, 6270380.13137481, 6265647.35458069, 6226578.75095016, 6226511.37152686, 6249203.52891417, 6259397.06728075, 6280436.33379487, 6299894.32600657, 6304601.69369724, 6270380.13137481))
6;293;MORLAIX;FINISTERE;37929;8406;3243;5804;10171;65553;8615;0;222;38063;20029;132482;1601;29;;list(c(165337.426013502, 181098.291020738, 188602.287395605, 206169.313891807, 210063.39919682, 211079.167452786, 220827.182056713, 216510.665816557, 173627.340242724, 165337.426013502, 6866754.7561989, 6866087.72607052, 6862379.10754613, 6866023.60378255, 6860225.09401707, 6862090.9684998, 6843492.83365898, 6817386.08270821, 6840498.66245154, 6866754.7561989))
7;295;QUIMPERLE;FINISTERE;18331;827;399;143;7324;27024;4470;0;2634;28319;12625;75072;81;29;;list(c(216704.50652019, 232038.20772053, 213256.206424703, 212183.103688591, 191291.451958199, 185069.381327141, 199057.490851079, 216704.50652019, 6812182.84416623, 6779634.77918271, 6761640.33121857, 6764249.72040658, 6765019.39185521, 6769163.92931573, 6797308.56553438, 6812182.84416623))
8;223;LANNION;COTES DU NORD;34905;4516;4119;4031;13906;61477;6121;0;140;8886;13974;90598;260;22;;list(c(220827.182056713, 211079.167452786, 216599.69360266, 244182.829370953, 251769.91245177, 220827.182056713, 6843492.83365898, 6862090.9684998, 6872231.67610092, 6880923.06679276, 6873430.02626368, 6843492.83365898))
9;563;NAPOLEONVILLE;MORBIHAN;54598;666;1414;176;15722;72576;15281;0;1446;67079;17648;174030;570;56;;list(c(217546.080404177, 251542.375082009, 273378.551223271, 271480.385894432, 249376.955985561, 232038.20772053, 216704.50652019, 217546.080404177, 6815209.40172717, 6819057.8548431, 6775725.57518249, 6771360.89125823, 6763704.23180291, 6779634.77918271, 6812182.84416623, 6815209.40172717))
10;222;GUINGAMP;COTES DU NORD;50900;1915;2241;4790;41847;101693;18685;0;2430;33621;16580;173009;1462;22;;list(c(220827.182056713, 251769.91245177, 265218.366692306, 254437.850418976, 251542.375082009, 217546.080404177, 216510.665816557, 220827.182056713, 6843492.83365898, 6873430.02626368, 6860148.26677793, 6820786.42024523, 6819057.8548431, 6815209.40172717, 6817386.08270821, 6843492.83365898))
11;853;LES SABLES D'OLONNE;VENDEE;56399;17888;2705;8286;47686;132964;44157;4645;295;23630;17246;222937;5422;85;;list(c(311701.222360397, 363627.627635518, 359073.147713549, 354421.27893028, 342798.056005528, 331088.081042848, 328456.328381178, 322393.710706145, 308247.925617673, 307802.274606958, 311701.222360397, 6654155.0659179, 6599474.28571819, 6594955.75053946, 6598249.41459262, 6601877.64995541, 6610585.71250594, 6623708.89273588, 6633660.72793156, 6648176.20512105, 6653474.91463685, 6654155.0659179))
12;564;VANNES;MORBIHAN;55750;1632;2099;570;6293;66344;20081;1693;1169;85639;23505;198431;678;56;;list(c(249376.955985561, 271480.385894432, 294224.83903973, 292283.014419966, 282846.768546687, 280942.693644218, 288975.102275955, 285145.877973609, 262401.994711523, 270784.2404612, 266003.531950138, 240583.485148352, 249376.955985561, 6763704.23180291, 6771360.89125823, 6746035.92181125, 6719475.04636898, 6708538.7864017, 6711804.37310795, 6719513.77631054, 6728568.07980493, 6725761.57482742, 6735676.31888714, 6740429.26882959, 6734084.6547795, 6763704.23180291))
13;502;CHERBOURG;MANCHE;24531;2167;4216;7095;4602;42611;5385;0;156;6044;5744;59940;251;50;;list(c(349983.835675152, 348991.696322435, 359311.483232598, 366237.418350815, 381000.884558899, 386559.542745216, 349983.835675152, 6934258.82054402, 6960943.91726325, 6963612.53154597, 6958934.56865681, 6964976.98465603, 6963561.48703167, 6934258.82054402))
14;225;SAINT BRIEUC;COTES DU NORD;62545;5947;2810;4737;27044;103083;9726;0;2934;18601;12862;147206;115;22;;list(c(302876.547176457, 297644.794016468, 254437.850418976, 265218.366692306, 271095.283406251, 271105.89940111, 283898.033332986, 291106.729219568, 301530.552459967, 302876.547176457, 6844994.47539611, 6819473.01132151, 6820786.42024523, 6860148.26677793, 6854344.19495552, 6848503.1922443, 6839669.61221585, 6847421.13846137, 6851824.51057787, 6844994.47539611))
15;224;LOUDEAC;COTES DU NORD;42887;2872;2597;2919;13215;64490;13641;0;0;41619;16902;136652;0;22;;list(c(251542.375082009, 254437.850418976, 297644.794016468, 303947.375546461, 302894.862774472, 273378.551223271, 251542.375082009, 6819057.8548431, 6820786.42024523, 6819473.01132151, 6806973.93788198, 6800271.30163495, 6775725.57518249, 6819057.8548431))
16;444;PAIMBOEUF;LOIRE INFERIEURE;25966;2250;1179;1640;16358;47393;12292;4086;0;3057;10042;76870;1105;44;;list(c(292283.014419966, 311790.899480846, 335931.368813839, 329908.285430306, 311701.222360397, 307802.274606958, 307606.097012026, 322377.789805402, 299606.247936981, 288525.851811411, 282846.768546687, 292283.014419966, 6719475.04636898, 6720061.10002944, 6688136.18214315, 6661901.38143795, 6654155.0659179, 6653474.91463685, 6655807.43058332, 6670635.20670013, 6695023.93909366, 6698798.86556721, 6708538.7864017, 6719475.04636898))
17;221;DINAN;COTES DU NORD;60151;2160;2784;6824;24812;96731;8796;0;163;14602;20805;141097;600;22;;list(c(297644.794016468, 302876.547176457, 356001.633807923, 359044.540887524, 358009.466247122, 343975.940096315, 303947.375546461, 297644.794016468, 6819473.01132151, 6844994.47539611, 6833219.52140175, 6825877.62863358, 6821352.26642343, 6812309.86823756, 6806973.93788198, 6819473.01132151))
18;562;PLOERMEL;MORBIHAN;55850;731;1338;118;6000;64037;14320;0;1711;61655;18225;159948;130;56;;list(c(273378.551223271, 302894.862774472, 324880.387704018, 294224.83903973, 271480.385894432, 273378.551223271, 6775725.57518249, 6800271.30163495, 6766560.29232736, 6746035.92181125, 6771360.89125823, 6775725.57518249))
19;355;SAINT MALO;ILLE ET VILAINE;44293;3524;5774;4965;10310;68866;6087;0;404;6017;11547;92921;300;35;;list(c(301530.552459967, 307703.082892227, 316404.68138313, 322492.808156928, 330812.969220727, 335114.488364551, 329735.881855757, 336823.267018287, 348643.478072976, 355905.270464832, 356001.633807923, 302876.547176457, 301530.552459967, 6851824.51057787, 6854431.99420138, 6843750.69286666, 6846066.97625774, 6841201.40424807, 6838092.91032644, 6850108.67680499, 6855216.09067518, 6844179.87508346, 6845067.79765843, 6833219.52140175, 6844994.47539611, 6851824.51057787))
20;352;MONTFORT;ILLE ET VILAINE;41799;612;1583;2706;11936;58636;7848;0;532;13225;14394;94635;1;35;;list(c(303947.375546461, 343975.940096315, 337882.600323205, 324880.387704018, 302894.862774472, 303947.375546461, 6806973.93788198, 6812309.86823756, 6763464.54195364, 6766560.29232736, 6800271.30163495, 6806973.93788198))
21;353;REDON;ILLE ET VILAINE;46430;2286;1381;632;4441;55170;14748;190;379;47493;14977;132957;415;35;;list(c(311790.899480846, 292283.014419966, 294224.83903973, 324880.387704018, 337882.600323205, 343667.902880413, 345982.952725653, 311790.899480846, 6720061.10002944, 6719475.04636898, 6746035.92181125, 6766560.29232736, 6763464.54195364, 6759671.93674288, 6729844.70886303, 6720061.10002944))
22;445;SAVENAY;LOIRE INFERIEURE;45211;3380;2341;2733;15194;68859;44165;2515;446;55243;46664;217892;5310;44;;list(c(345982.952725653, 353993.256823915, 335931.368813839, 311790.899480846, 345982.952725653, 6729844.70886303, 6721012.84314473, 6688136.18214315, 6720061.10002944, 6729844.70886303))
23;851;NAPOLEON VENDEE;VENDEE;63814;21278;4430;10346;59385;159253;28990;5200;769;19520;23186;236918;5;85;;list(c(329908.285430306, 370404.1756753, 388027.464792731, 375329.159472909, 363627.627635518, 311701.222360397, 329908.285430306, 6661901.38143795, 6658991.81487105, 6633500.70347774, 6605010.21843292, 6599474.28571819, 6654155.0659179, 6661901.38143795))
24;354;RENNES;ILLE ET VILAINE;65511;1830;3779;5283;12713;89116;16612;0;2362;12561;16935;137586;86;35;;list(c(358009.466247122, 370494.990829198, 368217.746268859, 343667.902880413, 337882.600323205, 343975.940096315, 358009.466247122, 6821352.26642343, 6801612.35744176, 6770334.86391278, 6759671.93674288, 6763464.54195364, 6812309.86823756, 6821352.26642343))
25;443;NANTES;LOIRE INFERIEURE;49861;10103;4726;6825;18285;89800;28998;18617;1868;8426;26302;174011;3646;44;;list(c(335931.368813839, 353993.256823915, 361144.581483783, 380113.321635718, 370404.1756753, 329908.285430306, 335931.368813839, 6688136.18214315, 6721012.84314473, 6718876.26651231, 6678495.75969877, 6658991.81487105, 6661901.38143795, 6688136.18214315))
26;442;CHATEAUBRIANT;LOIRE INFERIEURE;41589;2000;1257;2922;19250;67018;19584;686;269;20598;31416;139571;37;44;;list(c(345982.952725653, 343667.902880413, 368217.746268859, 392385.058391878, 390022.879067526, 361144.581483783, 353993.256823915, 345982.952725653, 6729844.70886303, 6759671.93674288, 6770334.86391278, 6760776.28675634, 6729949.52824853, 6718876.26651231, 6721012.84314473, 6729844.70886303))
27;172;MARENNES;CHARENTE INFERIEURE;22524;2311;733;1200;10601;37369;13936;9954;6;7529;10267;79061;144;17;;list(list(c(371870.34613731, 372391.992605283, 373584.382046029, 360459.201558444, 367567.23369498, 371870.34613731, 6550962.09456857, 6550615.35293723, 6536625.8247949, 6548635.58950203, 6550228.42521835, 6550962.09456857)), list(c(401409.935548407, 392028.846341652, 388641.917293691, 370454.497846348, 384133.240895717, 401409.935548407, 6531326.946915, 6504158.19766274, 6507730.36925279, 6521016.62746479, 6542810.87263076, 6531326.946915)))
28;642;MAULEON;BASSES PYRENEES;19765;640;621;78;850;21954;17897;3991;3160;88544;57990;193536;0;64;;list(c(366513.107179435, 399927.778403297, 388835.8763202, 375512.430710803, 348960.902576422, 338399.128791859, 366513.107179435, 6265647.35458069, 6254618.80486318, 6213282.43189554, 6215300.10086681, 6228422.27506198, 6226578.75095016, 6265647.35458069))
29;493;CHOLET;MAINE ET LOIRE;50662;21725;3080;12823;24983;113273;22000;2833;382;6985;16313;161786;120;49;;list(c(380113.321635718, 411792.949252862, 434782.39191259, 436050.701180355, 405515.619364743, 388027.464792731, 370404.1756753, 380113.321635718, 6678495.75969877, 6694681.57047944, 6682371.90430678, 6678967.97183472, 6634444.30959204, 6633500.70347774, 6658991.81487105, 6678495.75969877))
30;501;AVRANCHES;MANCHE;48469;497;3903;12736;5748;71353;11719;0;3302;2094;8859;97327;1037;50;;list(c(356001.633807923, 355905.270464832, 363324.730517147, 375356.985127829, 363901.721922739, 362600.503702766, 362761.955382229, 391834.377643521, 398644.311447795, 391873.657337058, 359044.540887524, 356001.633807923, 6833219.52140175, 6845067.79765843, 6845974.99876237, 6847183.51200123, 6860071.92903129, 6869319.66889687, 6870021.64964887, 6873475.5235413, 6856353.21966245, 6833963.12812604, 6825877.62863358, 6833219.52140175))
31;173;LA ROCHELLE;CHARENTE INFERIEURE;25769;1549;5448;3353;7780;43899;9972;17927;3;1123;8372;81296;2796;17;;"list(list(c(363627.627635518, 375329.159472909, 407549.074791445, 407819.238769976, 385269.553802659, 373714.381277741, 384298.22657854, 375801.174884663, 359073.147713549, 363627.627635518, 6599474.28571819, 6605010.21843292, 6572713.72270438, 6571749.54912325, 6558710.18915547, 6571643.55448755, 6587657.18741137, 6583111.80043236, 6594955.75053946, 6599474.28571819)), list(c(371870.34613731, 367567.23369498, 372333.927624502, 372339.323857117, 371870.34613731, 6550962.09456857, 6550228.42521835, 
6551296.59151161, 6551233.28103145, 6550962.09456857)))"
32;503;COUTANCES;MANCHE;60503;1663;5941;20064;4046;92217;13414;0;2203;13519;10569;131922;3109;50;;list(c(384530.907458668, 392542.876386223, 391834.377643521, 362761.955382229, 366239.896650729, 365063.794074368, 359451.426824039, 384530.907458668, 6918397.10840546, 6874492.67375122, 6873475.5235413, 6870021.64964887, 6885143.49808807, 6902494.52261329, 6918712.38177004, 6918397.10840546))
33;506;VALOGNES;MANCHE;36284;3043;6441;8556;3874;58198;25316;0;3113;7137;9881;103645;3639;50;;list(c(384530.907458668, 359451.426824039, 357824.418998411, 350022.369332795, 349983.835675152, 386559.542745216, 391655.598082911, 394385.072581647, 388384.605989653, 396887.300531528, 397972.153247144, 384530.907458668, 6918397.10840546, 6918712.38177004, 6923413.88874313, 6933222.39922041, 6934258.82054402, 6963561.48703167, 6962263.79000077, 6955420.61061124, 6946159.18983269, 6932536.32079889, 6926071.04382827, 6918397.10840546))
34;762;LE HAVRE;SEINE INFERIEURE;38350;3455;6087;12980;6949;67821;2387;0;4813;1081;11700;87802;58;76;;list(c(515395.06253986, 504467.188253636, 490048.163553813, 490235.722554907, 503883.630749091, 506949.280079913, 491230.487255943, 487468.417671729, 498533.520181211, 509238.058345855, 515395.06253986, 6942832.53802273, 6925250.37636354, 6925296.87443889, 6925427.60796298, 6928965.80181616, 6930587.90113522, 6933136.21244298, 6938678.62017314, 6960770.19008969, 6966451.48315698, 6942832.53802273))
35;441;ANCENIS;LOIRE INFERIEURE;27448;1783;1849;1775;18117;50972;11089;3679;49;1777;11547;79113;0;44;;list(c(361144.581483783, 390022.879067526, 407430.711577543, 411792.949252862, 380113.321635718, 361144.581483783, 6718876.26651231, 6729949.52824853, 6717403.31075692, 6694681.57047944, 6678495.75969877, 6718876.26651231))
36;334;LESPARRE;GIRONDE;19041;2400;814;1179;8755;32189;7859;12314;0;45580;22473;120415;2206;33;;list(c(405691.276051955, 413959.223341818, 374623.016643406, 366862.173852928, 374026.184407441, 375774.868094058, 380189.815596881, 402236.930626552, 408778.845086584, 399633.704043613, 393255.421931766, 405691.276051955, 6496941.75104033, 6476463.05277884, 6432883.17653833, 6428896.93439912, 6475505.38104247, 6495704.62996069, 6501906.12950991, 6479283.90509997, 6476653.29048845, 6496137.40471296, 6502864.53652783, 6496941.75104033))
37;401;DAX;LANDES;39033;2066;2943;660;1837;46539;11568;5752;1294;59476;106499;231128;3908;40;;list(c(343612.807841696, 355143.283814911, 359920.521155646, 369944.265368306, 390543.395269061, 393559.685868328, 366664.007018827, 343612.807841696, 6304601.69369724, 6347690.8888124, 6373315.16541796, 6369805.81723441, 6319615.822298, 6294711.6868232, 6270380.13137481, 6304601.69369724))
38;351;FOUGERES;ILLE ET VILAINE;45559;1776;1889;7252;11702;68178;10730;0;200;8213;12316;99637;193;35;;list(c(359044.540887524, 391873.657337058, 412038.615415673, 409196.138855901, 407320.297064038, 370494.990829198, 358009.466247122, 359044.540887524, 6825877.62863358, 6833963.12812604, 6818280.63737595, 6801104.46666105, 6799458.71239034, 6801612.35744176, 6821352.26642343, 6825877.62863358))
39;141;BAYEUX;CALVADOS;28587;2072;8923;5582;1693;46857;33657;0;0;1580;12818;94912;1300;14;;list(c(431848.64599574, 426926.203029956, 403843.680737918, 404607.382782206, 420379.971356533, 448135.670160505, 431848.64599574, 6887325.15072152, 6888769.61363838, 6927622.98159201, 6928818.27473436, 6924888.43210127, 6921019.09792491, 6887325.15072152))
40;356;VITRE;ILLE ET VILAINE;50712;1799;3188;4365;13896;73960;15847;0;486;7034;17520;114847;14;35;;list(c(370494.990829198, 407320.297064038, 398970.68972423, 392385.058391878, 368217.746268859, 370494.990829198, 6801612.35744176, 6799458.71239034, 6764145.54180272, 6760776.28675634, 6770334.86391278, 6801612.35744176))
41;146;VIRE;CALVADOS;41949;1101;3335;12541;6085;65011;12166;0;5121;2736;10590;95624;37;14;;list(c(392542.876386223, 426926.203029956, 431848.64599574, 439430.697586147, 441819.130175084, 422467.608189093, 398644.311447795, 391834.377643521, 392542.876386223, 6874492.67375122, 6888769.61363838, 6887325.15072152, 6879860.50514118, 6861529.68843023, 6850976.88976322, 6856353.21966245, 6873475.5235413, 6874492.67375122))
42;532;LAVAL;MAYENNE;66606;3021;3056;20269;28702;121654;27497;0;1541;9494;20877;181063;3;53;;list(c(409196.138855901, 455864.302743669, 454635.258610273, 401432.225160135, 398970.68972423, 407320.297064038, 409196.138855901, 6801104.46666105, 6779021.54053465, 6771324.39339194, 6763617.44201162, 6764145.54180272, 6799458.71239034, 6801104.46666105))
43;651;ARGELES;HAUTES PYRENEES;7360;679;412;292;263;9006;12638;110;506;78876;30019;131155;16;65;;list(c(429146.089061457, 441673.019508371, 459810.586174929, 448820.695809505, 441704.498755296, 428969.697675054, 422125.289410514, 412991.857682874, 429146.089061457, 6230184.03858976, 6236711.94578474, 6226532.20738954, 6186101.02749504, 6193323.09383857, 6200124.40123883, 6195005.81104454, 6197310.23226042, 6230184.03858976))
44;644;ORTHEZ;BASSES PYRENEES;36012;154;2097;535;1930;40728;10552;5568;867;34588;25882;118185;32;64;;list(c(366664.007018827, 393559.685868328, 420268.639073439, 408227.302706668, 399927.778403297, 366513.107179435, 366664.007018827, 6270380.13137481, 6294711.6868232, 6277451.60105123, 6257556.86248434, 6254618.80486318, 6265647.35458069, 6270380.13137481))
45;852;FONTENAY LE COMTE;VENDEE;63760;7797;6200;12393;41786;131936;46794;5650;524;4290;21301;210495;4477;85;;list(c(388027.464792731, 405515.619364743, 426592.145921697, 431673.781381803, 407549.074791445, 375329.159472909, 388027.464792731, 6633500.70347774, 6634444.30959204, 6621913.35225246, 6610252.84353453, 6572713.72270438, 6605010.21843292, 6633500.70347774))
46;174;ROCHEFORT;CHARENTE INFERIEURE;26892;1565;923;1358;6833;37571;14167;12451;0;375;9644;74208;1601;17;;list(list(c(372339.323857117, 372391.992605283, 371870.34613731, 372339.323857117, 6551233.28103145, 6550615.35293723, 6550962.09456857, 6551233.28103145)), list(c(407819.238769976, 411120.496891479, 409560.335393191, 401409.935548407, 384133.240895717, 384427.309632723, 385939.515034539, 385269.553802659, 407819.238769976, 6571749.54912325, 6568360.80225914, 6539858.32172955, 6531326.946915, 6542810.87263076, 6543279.41028271, 6557960.32121957, 6558710.18915547, 6571749.54912325)))
47;495;SEGRE;MAINE ET LOIRE;48569;8388;2942;8475;16261;84635;15477;340;273;622;14891;116238;0;49;;list(c(392385.058391878, 398970.68972423, 401432.225160135, 429497.814735976, 407430.711577543, 390022.879067526, 392385.058391878, 6760776.28675634, 6764145.54180272, 6763617.44201162, 6734628.38669674, 6717403.31075692, 6729949.52824853, 6760776.28675634))
48;505;SAINT LO;MANCHE;53228;1374;2348;10388;6758;74096;24550;0;1126;2067;10757;112596;10;50;;list(c(384530.907458668, 397972.153247144, 398987.176727639, 403843.680737918, 426926.203029956, 392542.876386223, 384530.907458668, 6918397.10840546, 6926071.04382827, 6920021.92044164, 6927622.98159201, 6888769.61363838, 6874492.67375122, 6918397.10840546))
49;793;NIORT;DEUX SEVRES;52326;2497;3449;7996;29287;95555;19735;9702;1027;1223;14151;141393;2423;79;;list(c(407549.074791445, 431673.781381803, 456116.351625636, 436771.653028728, 411120.496891479, 407819.238769976, 407549.074791445, 6572713.72270438, 6610252.84353453, 6596939.01865357, 6564539.86423317, 6568360.80225914, 6571749.54912325, 6572713.72270438))
50;175;SAINTES;CHARENTE INFERIEURE;59633;4223;1362;5525;9079;79822;14391;29470;40;3650;28058;155431;1966;17;;list(c(401409.935548407, 409560.335393191, 431138.929034572, 424592.993261896, 405691.276051955, 393255.421931766, 392028.846341652, 401409.935548407, 6531326.946915, 6539858.32172955, 6528949.02540453, 6505555.53345267, 6496941.75104033, 6502864.53652783, 6504158.19766274, 6531326.946915))
51;333;BORDEAUX;GIRONDE;28453;6572;4519;1589;9084;50217;17498;45212;663;194919;114987;423496;2150;33;;list(c(374623.016643406, 428549.062203538, 434427.56317512, 432377.493929957, 376084.97206364, 369944.265368306, 359920.521155646, 361797.688121494, 362002.621564167, 369613.579013239, 366350.476617237, 366862.173852928, 374623.016643406, 6432883.17653833, 6442019.11420874, 6404256.40486455, 6401631.38656498, 6369911.02778551, 6369805.81723441, 6373315.16541796, 6383383.96504773, 6390836.71180658, 6413804.05797783, 6425567.87546966, 6428896.93439912, 6432883.17653833))
52;504;MORTAIN;MANCHE;41636;312;1786;5777;8982;58493;11707;0;2991;3708;10509;87408;40;50;;list(c(398644.311447795, 422467.608189093, 417595.622849596, 412038.615415673, 391873.657337058, 398644.311447795, 6856353.21966245, 6850976.88976322, 6821730.35501103, 6818280.63737595, 6833963.12812604, 6856353.21966245))
53;403;SAINT SEVER;LANDES;42739;8886;3511;1708;7134;63978;6556;7806;1561;50551;40684;171136;1793;40;;list(c(390543.395269061, 454519.278582272, 451568.182425857, 420268.639073439, 393559.685868328, 390543.395269061, 6319615.822298, 6294639.63102096, 6287127.09253922, 6277451.60105123, 6294711.6868232, 6319615.822298))
54;643;OLORON;BASSES PYRENEES;17429;443;1079;258;500;19709;18311;3909;1122;94679;48661;186391;76;64;;list(c(408227.302706668, 429146.089061457, 412991.857682874, 405173.225484314, 388869.625235063, 388835.8763202, 399927.778403297, 408227.302706668, 6257556.86248434, 6230184.03858976, 6197310.23226042, 6199282.92143736, 6213277.32104507, 6213282.43189554, 6254618.80486318, 6257556.86248434))
55;332;BLAYE;GIRONDE;21170;3625;562;468;2376;28201;9481;17787;56;3295;12908;71728;210;33;;list(c(413959.223341818, 441965.952589453, 428549.062203538, 374623.016643406, 413959.223341818, 6476463.05277884, 6459270.54696946, 6442019.11420874, 6432883.17653833, 6476463.05277884))
56;533;MAYENNE;MAYENNE;85976;1943;4161;18510;35862;146452;27208;0;817;12806;21922;209205;363;53;;list(c(417595.622849596, 456095.902848096, 463418.75359312, 455864.302743669, 409196.138855901, 412038.615415673, 417595.622849596, 6821730.35501103, 6823734.97969019, 6790540.5035433, 6779021.54053465, 6801104.46666105, 6818280.63737595, 6821730.35501103))
57;491;ANGERS;MAINE ET LOIRE;45758;10438;9110;10182;21252;96740;21410;10582;288;4862;20703;154585;0;49;;list(c(407430.711577543, 429497.814735976, 444380.172419551, 444959.968644415, 451633.666978939, 434782.39191259, 411792.949252862, 407430.711577543, 6717403.31075692, 6734628.38669674, 6737996.06506132, 6736957.4395729, 6705440.20308741, 6682371.90430678, 6694681.57047944, 6717403.31075692))
58;171;JONZAC;CHARENTE INFERIEURE;55818;8590;1477;2673;8361;76919;15929;16920;0;12120;30466;152354;60;17;;list(c(405691.276051955, 424592.993261896, 441169.8800748, 447931.331579044, 441965.952589453, 413959.223341818, 405691.276051955, 6496941.75104033, 6505555.53345267, 6500861.77622976, 6460528.56363911, 6459270.54696946, 6476463.05277884, 6496941.75104033))
59;531;CHATEAU GONTIER;MAYENNE;47456;5198;3030;14025;25786;95495;18479;0;440;1659;10722;126795;4;53;;list(c(401432.225160135, 454635.258610273, 455169.650311948, 444380.172419551, 429497.814735976, 401432.225160135, 6763617.44201162, 6771324.39339194, 6768929.84797174, 6737996.06506132, 6734628.38669674, 6763617.44201162))
60;176;SAINT JEAN D'ANGELY;CHARENTE INFERIEURE;50813;4112;1299;5043;17394;78661;11077;29275;0;1560;19646;140219;1730;17;;list(c(411120.496891479, 436771.653028728, 456138.422757332, 456609.017259581, 431138.929034572, 409560.335393191, 411120.496891479, 6568360.80225914, 6564539.86423317, 6543797.27297649, 6540636.26658967, 6528949.02540453, 6539858.32172955, 6568360.80225914))
61;645;PAU;BASSES PYRENEES;37143;1368;2359;2280;7534;50684;16008;9133;6203;47200;31477;160705;557;64;;list(c(451568.182425857, 454730.363976155, 441673.019508371, 429146.089061457, 408227.302706668, 420268.639073439, 451568.182425857, 6287127.09253922, 6277274.41873031, 6236711.94578474, 6230184.03858976, 6257556.86248434, 6277451.60105123, 6287127.09253922))
62;721;LA FLECHE;SARTHE;50252;11594;4223;9786;26838;102693;15990;4410;531;8466;28109;160199;850;72;;list(c(455169.650311948, 506238.198934388, 507246.688682335, 498613.870821235, 444959.968644415, 444380.172419551, 455169.650311948, 6768929.84797174, 6736046.92113267, 6733565.98204686, 6719775.40532942, 6736957.4395729, 6737996.06506132, 6768929.84797174))
63;791;BRESSUIRE;DEUX SEVRES;54624;9552;2595;6492;33756;107019;23488;5802;72;10490;16401;163272;0;79;;list(c(405515.619364743, 436050.701180355, 453775.644505492, 460572.137821031, 426592.145921697, 405515.619364743, 6634444.30959204, 6678967.97183472, 6666050.5205684, 6645077.2363715, 6621913.35225246, 6634444.30959204))
64;402;MONT DE MARSAN;LANDES;45212;1209;5269;365;5542;57597;9836;6578;687;273129;182040;529867;4474;40;;list(c(369944.265368306, 376084.97206364, 449717.509927035, 453562.135254592, 455875.724286721, 454519.278582272, 390543.395269061, 369944.265368306, 6369805.81723441, 6369911.02778551, 6338885.05579743, 6327874.33917401, 6296828.35168554, 6294639.63102096, 6319615.822298, 6369805.81723441))
65;335;LIBOURNE;GIRONDE;31678;7087;1741;4911;9893;55310;15510;35957;87;3932;18224;129020;0;33;;list(c(441965.952589453, 447931.331579044, 458612.654041236, 475203.568919606, 472262.982548517, 434427.56317512, 428549.062203538, 441965.952589453, 6459270.54696946, 6460528.56363911, 6459062.54023829, 6437040.24107768, 6418100.78983448, 6404256.40486455, 6442019.11420874, 6459270.54696946))
66;613;DOMFRONT;ORNE;46181;620;2695;10973;14998;75467;18321;0;1997;4025;23554;123364;0;61;;list(c(422467.608189093, 441819.130175084, 453175.1336299, 458512.423623234, 456095.902848096, 417595.622849596, 422467.608189093, 6850976.88976322, 6861529.68843023, 6849379.02508804, 6830457.75234454, 6823734.97969019, 6821730.35501103, 6850976.88976322))
67;331;BAZAS;GIRONDE;22997;1962;4612;1168;3032;33771;8959;8334;375;30202;66756;148397;125;33;;list(c(432377.493929957, 460028.703456007, 463655.450773478, 449717.509927035, 376084.97206364, 432377.493929957, 6401631.38656498, 6376236.06572439, 6355944.43651757, 6338885.05579743, 6369911.02778551, 6401631.38656498))
68;473;NERAC;LOT ET GARONNE;31236;1966;1387;3768;16083;54440;6740;13124;324;20366;43826;138820;1850;47;;list(c(463655.450773478, 493040.325800726, 502472.672008306, 502233.074521608, 453562.135254592, 449717.509927035, 463655.450773478, 6355944.43651757, 6365037.71495277, 6332984.63922171, 6332722.48174934, 6327874.33917401, 6338885.05579743, 6355944.43651757))
69;325;MIRANDE;GERS;54410;2183;1793;5960;23470;87816;18550;24460;141;8107;30223;169297;600;32;;list(c(454519.278582272, 455875.724286721, 477921.17313184, 509994.91155375, 507019.270077234, 490566.888051787, 454730.363976155, 451568.182425857, 454519.278582272, 6294639.63102096, 6296828.35168554, 6297072.21442672, 6268344.67230961, 6252343.38443091, 6243378.2550094, 6277274.41873031, 6287127.09253922, 6294639.63102096))
70;142;CAEN;CALVADOS;40374;2425;18539;16830;5213;83381;12875;0;113;1949;9840;108211;156;14;;list(c(476136.498777799, 475530.455938224, 439430.697586147, 431848.64599574, 448135.670160505, 451915.027620871, 465544.902699097, 471497.388122536, 476136.498777799, 6897668.44702043, 6893035.98470882, 6879860.50514118, 6887325.15072152, 6921019.09792491, 6920492.22965583, 6914302.26772034, 6914722.14802767, 6897668.44702043))
71;723;LE MANS;SARTHE;63626;12042;8441;18110;22440;124659;18960;2138;538;8408;34180;188883;162;72;;list(c(454635.258610273, 455864.302743669, 463418.75359312, 485779.370345984, 514193.710209429, 506238.198934388, 455169.650311948, 454635.258610273, 6771324.39339194, 6779021.54053465, 6790540.5035433, 6793158.12778737, 6783166.55779272, 6736046.92113267, 6768929.84797174, 6771324.39339194))
72;163;COGNAC;CHARENTE;22790;3387;616;1991;1867;30651;7126;23461;0;1191;9087;71516;1111;16;;list(c(431138.929034572, 456609.017259581, 462879.829045278, 458550.16662634, 441169.8800748, 424592.993261896, 431138.929034572, 6528949.02540453, 6540636.26658967, 6533207.18402381, 6510262.70079515, 6500861.77622976, 6505555.53345267, 6528949.02540453))
73;792;MELLE;DEUX SEVRES;51605;3432;3011;12268;29363;99679;11168;3804;482;1075;21085;137293;454;79;;list(c(456116.351625636, 472309.884070221, 480245.382061797, 474479.889037518, 456138.422757332, 436771.653028728, 456116.351625636, 6596939.01865357, 6598603.45164209, 6590513.55880218, 6567602.89672012, 6543797.27297649, 6564539.86423317, 6596939.01865357))
74;143;FALAISE;CALVADOS;43156;2087;4557;8643;6133;64576;7002;0;390;2347;12733;87048;271;14;;list(c(439430.697586147, 475530.455938224, 491300.575026229, 453175.1336299, 441819.130175084, 439430.697586147, 6879860.50514118, 6893035.98470882, 6873474.75593241, 6849379.02508804, 6861529.68843023, 6879860.50514118))
75;494;SAUMUR;MAINE ET LOIRE;41894;9225;5585;7801;14672;79177;13613;13086;0;5700;27278;138854;0;49;;list(c(434782.39191259, 451633.666978939, 489875.00515062, 475439.457650233, 453775.644505492, 436050.701180355, 434782.39191259, 6682371.90430678, 6705440.20308741, 6706625.23071038, 6676055.35243445, 6666050.5205684, 6678967.97183472, 6682371.90430678))
76;794;PARTHENAY;DEUX SEVRES;45810;9298;3116;5954;43307;107485;18736;2352;14;8328;21115;158030;103;79;;list(c(460572.137821031, 478582.553792194, 472309.884070221, 456116.351625636, 431673.781381803, 426592.145921697, 460572.137821031, 6645077.2363715, 6632585.80772185, 6598603.45164209, 6596939.01865357, 6610252.84353453, 6621913.35225246, 6645077.2363715))
77;492;BAUGE;MAINE ET LOIRE;48177;8630;3588;6177;20529;87101;13350;3658;91;9554;26875;140629;300;49;;list(c(444959.968644415, 498613.870821235, 495178.423129868, 489875.00515062, 451633.666978939, 444959.968644415, 6736957.4395729, 6719775.40532942, 6709656.70259786, 6706625.23071038, 6705440.20308741, 6736957.4395729))
78;336;LA REOLE;GIRONDE;23850;2007;907;2786;7486;37036;8984;18102;234;1539;15081;80976;0;33;;list(c(472262.982548517, 479100.854479492, 460028.703456007, 432377.493929957, 434427.56317512, 472262.982548517, 6418100.78983448, 6407520.31117399, 6376236.06572439, 6401631.38656498, 6404256.40486455, 6418100.78983448))
79;162;BARBEZIEUX;CHARENTE;30658;7581;796;4216;4850;48101;10943;11295;21;5771;22658;98789;200;16;;list(c(447931.331579044, 441169.8800748, 458550.16662634, 477246.983772915, 458612.654041236, 447931.331579044, 6460528.56363911, 6500861.77622976, 6510262.70079515, 6484331.75101967, 6459062.54023829, 6460528.56363911))
80;661;CERET;PYRENEES ORIENTALES;11593;3727;421;1237;3200;20178;1988;11417;4519;32227;22071;92400;0;66;;list(c(672894.443744574, 703356.25580446, 703330.608892655, 686647.507747352, 665186.700982499, 657108.69467275, 654596.237288374, 672894.443744574, 6171562.68776639, 6156740.95751159, 6152707.70074619, 6150926.50150212, 6139875.41366729, 6138134.59417127, 6139629.1013051, 6171562.68776639))
81;241;BERGERAC;DORDOGNE;65120;8027;1425;3996;18553;97121;15931;28406;7842;12810;57614;219724;0;24;;list(c(475203.568919606, 501966.746225467, 529151.181038929, 531227.694618586, 501419.483179052, 479100.854479492, 472262.982548517, 475203.568919606, 6437040.24107768, 6443296.5264927, 6429759.92784062, 6403626.44225352, 6391909.88378836, 6407520.31117399, 6418100.78983448, 6437040.24107768))
82;165;RUFFEC;CHARENTE;36859;3807;1439;6472;4353;52930;6243;11103;1676;959;14078;86989;394;16;;list(c(456138.422757332, 474479.889037518, 501155.269350421, 499645.086124573, 462879.829045278, 456609.017259581, 456138.422757332, 6543797.27297649, 6567602.89672012, 6548394.76322339, 6528331.31737047, 6533207.18402381, 6540636.26658967, 6543797.27297649))
83;144;LISIEUX;CALVADOS;21109;1403;900;1427;8651;33490;26965;0;15105;1522;11911;88993;45;14;;list(c(476136.498777799, 507248.212395714, 514353.97452705, 504368.173155704, 491300.575026229, 475530.455938224, 476136.498777799, 6897668.44702043, 6910757.15532338, 6903712.36870181, 6867690.8556329, 6873474.75593241, 6893035.98470882, 6897668.44702043))
84;863;LOUDUN;VIENNE;39897;2111;812;7825;14762;65407;4227;5122;0;2490;12672;89918;79;86;;list(c(453775.644505492, 475439.457650233, 502987.418137342, 488061.2129208, 478582.553792194, 460572.137821031, 453775.644505492, 6666050.5205684, 6676055.35243445, 6658149.98581674, 6636264.57306872, 6632585.80772185, 6645077.2363715, 6666050.5205684))
85;161;ANGOULEME;CHARENTE;52317;10620;1840;8778;6785;80340;16168;46616;2005;6342;43913;195384;40;16;;list(c(462879.829045278, 499645.086124573, 503192.989857199, 504542.956121263, 494131.564774311, 477246.983772915, 458550.16662634, 462879.829045278, 6533207.18402381, 6528331.31737047, 6524702.21920991, 6520687.71038801, 6489438.04066011, 6484331.75101967, 6510262.70079515, 6533207.18402381))
86;244;RIBERAC;DORDOGNE;36856;7878;1737;2337;7588;56396;13634;15058;3817;9145;48403;146453;54;24;;list(c(477246.983772915, 494131.564774311, 509178.610238151, 501966.746225467, 475203.568919606, 458612.654041236, 477246.983772915, 6484331.75101967, 6489438.04066011, 6476147.61424436, 6443296.5264927, 6437040.24107768, 6459062.54023829, 6484331.75101967))
87;653;TARBES;HAUTES PYRENEES;34841;2067;2243;1606;16626;57383;16556;13650;4641;15171;23306;130707;208;65;;list(c(454730.363976155, 490566.888051787, 486903.586053953, 459810.586174929, 441673.019508371, 454730.363976155, 6277274.41873031, 6243378.2550094, 6230252.6569255, 6226532.20738954, 6236711.94578474, 6277274.41873031))
88;472;MARMANDE;LOT ET GARONNE;46744;3122;4755;6308;18625;79554;14600;22850;155;1789;21959;140907;22;47;;list(c(460028.703456007, 479100.854479492, 501419.483179052, 495798.980266077, 493040.325800726, 463655.450773478, 460028.703456007, 6376236.06572439, 6407520.31117399, 6391909.88378836, 6367883.18782614, 6365037.71495277, 6355944.43651757, 6376236.06572439))
89;652;BAGNERES;HAUTES PYRENEES;23616;2988;1647;1771;3474;33496;18305;1659;3009;75919;58694;191082;4;65;;list(c(459810.586174929, 486903.586053953, 502573.34843539, 493119.596053144, 468515.872091452, 453967.778909207, 448820.695809505, 459810.586174929, 6226532.20738954, 6230252.6569255, 6180108.80827988, 6181123.70686849, 6185984.8301302, 6180877.37006418, 6186101.02749504, 6226532.20738954))
90;663;PRADES;PYRENEES ORIENTALES;12879;3662;455;798;11753;29547;6045;7543;646;98153;40804;182738;0;66;;list(c(616778.080539632, 666260.338528975, 672894.443744574, 654596.237288374, 638774.984858247, 624534.622617057, 601560.195757318, 601133.318479367, 616778.080539632, 6183699.03516822, 6198492.18006971, 6171562.68776639, 6139629.1013051, 6149040.19610412, 6141006.5234697, 6155251.1175896, 6158181.00335885, 6183699.03516822))
91;612;ARGENTAN;ORNE;59302;1848;1925;13260;20464;96799;55617;0;2398;4073;28096;186983;832;61;;list(c(453175.1336299, 491300.575026229, 504368.173155704, 510433.480346028, 499461.594564112, 458512.423623234, 453175.1336299, 6849379.02508804, 6873474.75593241, 6867690.8556329, 6860518.98753655, 6838539.09489433, 6830457.75234454, 6849379.02508804))
92;145;PONTS L'EVEQUE;CALVADOS;12560;1464;876;1930;7149;23979;28548;0;11084;1180;12494;77285;0;14;;list(c(471497.388122536, 475257.477250932, 490048.163553813, 504467.188253636, 507248.212395714, 476136.498777799, 471497.388122536, 6914722.14802767, 6914987.37965219, 6925296.87443889, 6925250.37636354, 6910757.15532338, 6897668.44702043, 6914722.14802767))
93;371;CHINON;INDRE ET LOIRE;53402;7701;3579;8578;19761;93021;9967;11430;216;11614;43000;169248;1120;37;;list(c(489875.00515062, 495178.423129868, 518898.96372516, 517843.172598462, 502987.418137342, 475439.457650233, 489875.00515062, 6706625.23071038, 6709656.70259786, 6674994.87834574, 6666525.39995879, 6658149.98581674, 6676055.35243445, 6706625.23071038))
94;611;ALENCON;ORNE;34370;489;1119;5262;12704;53944;27015;0;138;2050;20178;103325;25;61;;list(c(458512.423623234, 499461.594564112, 502118.969216493, 485779.370345984, 463418.75359312, 456095.902848096, 458512.423623234, 6830457.75234454, 6838539.09489433, 6829529.57479918, 6793158.12778737, 6790540.5035433, 6823734.97969019, 6830457.75234454))
95;862;CIVRAY;VIENNE;35579;2252;1828;8651;19803;68113;8714;3015;770;20832;14144;115588;10;86;;list(c(480245.382061797, 510385.465541415, 515909.18208783, 501155.269350421, 474479.889037518, 480245.382061797, 6590513.55880218, 6586074.75061213, 6577585.41753522, 6548394.76322339, 6567602.89672012, 6590513.55880218))
96;322;CONDOM;GERS;42263;2712;1864;2565;15008;64412;14703;30901;131;17282;22532;149961;558;32;;list(c(453562.135254592, 502233.074521608, 498582.88243744, 477921.17313184, 455875.724286721, 453562.135254592, 6327874.33917401, 6332722.48174934, 6305562.05745527, 6297072.21442672, 6296828.35168554, 6327874.33917401))
97;865;POITIERS;VIENNE;62235;3770;3057;19619;31330;120011;10521;12508;19;13850;34214;191123;427;86;;list(c(472309.884070221, 478582.553792194, 488061.2129208, 523792.203356479, 510385.465541415, 480245.382061797, 472309.884070221, 6598603.45164209, 6632585.80772185, 6636264.57306872, 6614774.71554017, 6586074.75061213, 6590513.55880218, 6598603.45164209))
98;614;MORTAGNE;ORNE;63322;1078;2415;24733;31389;122937;28500;0;655;4000;39964;196056;2571;61;;list(c(499461.594564112, 510433.480346028, 538120.05664227, 545971.531723993, 554267.184888453, 522202.67219352, 502118.969216493, 499461.594564112, 6838539.09489433, 6860518.98753655, 6859596.04201104, 6853312.30114963, 6831397.96004846, 6812361.81626461, 6829529.57479918, 6838539.09489433))
99;373;TOURS;INDRE ET LOIRE;92221;7688;2809;12906;35928;151552;15100;21197;2895;12495;59049;262288;128;37;;list(c(498613.870821235, 507246.688682335, 528932.706823578, 545514.995329655, 554840.120129819, 518898.96372516, 495178.423129868, 498613.870821235, 6719775.40532942, 6733565.98204686, 6731658.12254011, 6720799.04380286, 6698706.38056573, 6674994.87834574, 6709656.70259786, 6719775.40532942))
100;164;CONFOLENS;CHARENTE;47664;4187;1629;3492;12913;69885;28873;4950;6569;14380;16903;141560;0;16;;list(c(499645.086124573, 501155.269350421, 515909.18208783, 528709.551263936, 536049.443946363, 503192.989857199, 499645.086124573, 6528331.31737047, 6548394.76322339, 6577585.41753522, 6572114.35984989, 6544914.53671172, 6524702.21920991, 6528331.31737047))
101;312;SAINT GAUDENS;HAUTE GARONNE;47890;6807;2042;4134;20759;81632;24181;7685;2507;13146;83653;212804;0;31;;list(c(507019.270077234, 542372.860894301, 520588.087943781, 512552.096654806, 507340.695428922, 508771.598449865, 502573.34843539, 486903.586053953, 490566.888051787, 507019.270077234, 6252343.38443091, 6238117.31260779, 6195638.54360249, 6198495.6807711, 6189794.33667037, 6179443.40104927, 6180108.80827988, 6230252.6569255, 6243378.2550094, 6252343.38443091))
102;861;CHATELLERAULT;VIENNE;35489;3497;1286;9733;16896;66901;4058;5304;13;11585;24617;112478;0;86;;list(c(502987.418137342, 517843.172598462, 542123.231743148, 529129.43925615, 523792.203356479, 488061.2129208, 502987.418137342, 6658149.98581674, 6666525.39995879, 6642725.91126385, 6617769.72908895, 6614774.71554017, 6636264.57306872, 6658149.98581674))
103;471;AGEN;LOT ET GARONNE;39084;3919;2795;6730;16230;68758;7300;12962;2021;1418;8744;101203;2;47;;list(c(495798.980266077, 531905.067275792, 531409.348844173, 520309.373779033, 502472.672008306, 493040.325800726, 495798.980266077, 6367883.18782614, 6352548.70476744, 6350660.18942488, 6333565.74538587, 6332984.63922171, 6365037.71495277, 6367883.18782614))
104;323;LECTOURE;GERS;39684;3662;1425;2822;13829;61422;10236;12379;6;1628;12841;98512;0;32;;list(c(502472.672008306, 520309.373779033, 536480.161400756, 534373.630957896, 498582.88243744, 502233.074521608, 502472.672008306, 6332984.63922171, 6333565.74538587, 6297392.84495693, 6296674.50578388, 6305562.05745527, 6332722.48174934, 6332984.63922171))
105;242;NONTRON;DORDOGNE;33744;8239;1219;2887;7611;53700;21340;9757;25688;20494;34991;165970;207;24;;list(c(504542.956121263, 539905.578574404, 538665.608093716, 509178.610238151, 494131.564774311, 504542.956121263, 6520687.71038801, 6505634.5539962, 6477004.61681662, 6476147.61424436, 6489438.04066011, 6520687.71038801))
106;275;PONT AUDEMER;EURE;28077;4124;3680;6095;9874;51850;9323;0;10925;3064;17723;92885;1475;27;;list(c(507248.212395714, 504467.188253636, 515395.06253986, 540079.821237026, 543350.122639953, 541676.558822682, 514353.97452705, 507248.212395714, 6910757.15532338, 6925250.37636354, 6942832.53802273, 6927415.29044812, 6912837.51371804, 6907863.71806547, 6903712.36870181, 6910757.15532338))
107;761;DIEPPE;SEINE INFERIEURE;47485;7603;6349;13547;6446;81430;7751;0;9299;3673;15056;117209;41;76;;list(c(589914.915746045, 563112.48766249, 534344.844752576, 561128.496253316, 583971.7246795, 586022.515636499, 589914.915746045, 6990277.22975543, 6956285.31511534, 6976886.21229474, 6982533.09628113, 6997563.48054227, 7000736.29682029, 6990277.22975543))
108;722;MAMERS;SARTHE;56012;2875;5678;25736;24664;114965;19664;342;208;1797;24670;161646;0;72;;list(c(502118.969216493, 522202.67219352, 518034.275559666, 514193.710209429, 485779.370345984, 502118.969216493, 6829529.57479918, 6812361.81626461, 6785262.46008274, 6783166.55779272, 6793158.12778737, 6829529.57479918))
109;272;BERNAY;EURE;38801;3529;2238;10643;14402;69613;4521;0;8209;2928;23847;109118;0;27;;list(c(504368.173155704, 514353.97452705, 541676.558822682, 546166.170387642, 538120.05664227, 510433.480346028, 504368.173155704, 6867690.8556329, 6903712.36870181, 6907863.71806547, 6894059.10106384, 6859596.04201104, 6860518.98753655, 6867690.8556329))
110;864;MONTMORILLON;VIENNE;46541;2487;1972;6256;43613;100869;18765;5661;36;38899;23700;187930;4;86;;list(c(510385.465541415, 523792.203356479, 529129.43925615, 557726.640716775, 556142.451578826, 528709.551263936, 515909.18208783, 510385.465541415, 6586074.75061213, 6614774.71554017, 6617769.72908895, 6597378.91487076, 6579396.04905343, 6572114.35984989, 6577585.41753522, 6586074.75061213))
111;321;AUCH;GERS;50029;2743;1536;3872;15150;73330;12347;20095;0;5107;19622;130501;0;32;;list(c(498582.88243744, 534373.630957896, 509994.91155375, 477921.17313184, 498582.88243744, 6305562.05745527, 6296674.50578388, 6268344.67230961, 6297072.21442672, 6305562.05745527))
112;324;LOMBEZ;GERS;30971;3461;1022;5987;12976;54417;5743;6757;0;1740;11103;79760;0;32;;list(c(534373.630957896, 536480.161400756, 543708.600505248, 548148.237887701, 543488.122167133, 542372.860894301, 507019.270077234, 509994.91155375, 534373.630957896, 6296674.50578388, 6297392.84495693, 6296616.16876499, 6283004.37663581, 6238512.61384916, 6238117.31260779, 6252343.38443091, 6268344.67230961, 6296674.50578388))
113;724;SAINT CALAIS;SARTHE;38682;3596;2078;11314;23427;79097;7509;2700;86;2362;18185;109939;0;72;;list(c(506238.198934388, 514193.710209429, 518034.275559666, 549128.326127473, 553076.104763499, 528932.706823578, 507246.688682335, 506238.198934388, 6736046.92113267, 6783166.55779272, 6785262.46008274, 6780865.59989624, 6768971.64126621, 6731658.12254011, 6733565.98204686, 6736046.92113267))
114;474;VILLENEUVE;LOT ET GARONNE;55296;4731;2383;5382;21366;89158;13160;17856;1814;2762;29716;154466;10;47;;list(c(501419.483179052, 531227.694618586, 539592.341813388, 547581.000889487, 548640.069233886, 531905.067275792, 495798.980266077, 501419.483179052, 6391909.88378836, 6403626.44225352, 6397792.42268526, 6386075.68599728, 6366077.47591139, 6352548.70476744, 6367883.18782614, 6391909.88378836))
115;243;PERIGUEUX;DORDOGNE;53259;10439;1282;1895;5013;71888;12076;23627;26133;12376;45644;191744;0;24;;list(c(509178.610238151, 538665.608093716, 552581.918654435, 551923.714820828, 529151.181038929, 501966.746225467, 509178.610238151, 6476147.61424436, 6477004.61681662, 6461754.371746, 6455777.02802237, 6429759.92784062, 6443296.5264927, 6476147.61424436))
116;093;SAINT GIRONS;ARIEGE;17844;5069;1345;4219;4548;33025;20302;1891;646;46472;47737;150073;11;09;;list(c(542372.860894301, 543488.122167133, 561131.981165032, 568192.230007291, 567601.779706067, 565300.604842032, 549651.096591997, 545982.265507062, 524684.717623538, 520588.087943781, 542372.860894301, 6238117.31260779, 6238512.61384916, 6234283.76400994, 6218627.25152845, 6177659.06622173, 6181413.67516585, 6180571.43571725, 6186549.39811494, 6194182.0172695, 6195638.54360249, 6238117.31260779))
117;873;ROCHECHOUART;HAUTE VIENNE;23452;4180;1548;84;7285;36549;20737;880;9769;3328;8582;79845;0;87;;list(c(504542.956121263, 503192.989857199, 536049.443946363, 546791.102827548, 548943.095050374, 539905.578574404, 504542.956121263, 6520687.71038801, 6524702.21920991, 6544914.53671172, 6539484.45111193, 6512723.86717678, 6505634.5539962, 6520687.71038801))
118;372;LOCHES;INDRE ET LOIRE;70783;4645;225;6204;30957;112814;8790;4258;0;23195;30777;179834;0;37;;list(c(518898.96372516, 554840.120129819, 573426.693227473, 583313.792577659, 569111.887096543, 542123.231743148, 517843.172598462, 518898.96372516, 6674994.87834574, 6698706.38056573, 6689064.98175424, 6667410.76593976, 6646633.70186804, 6642725.91126385, 6666525.39995879, 6674994.87834574))
119;765;YVETOT;SEINE INFERIEURE;45440;9055;7502;13748;4097;79842;5786;0;9344;2007;18619;115598;0;76;;list(c(509238.058345855, 525309.723572609, 534344.844752576, 563112.48766249, 563698.753605279, 540079.821237026, 515395.06253986, 509238.058345855, 6966451.48315698, 6974981.30843558, 6976886.21229474, 6956285.31511534, 6953982.22394851, 6927415.29044812, 6942832.53802273, 6966451.48315698))
120;764;ROUEN;SEINE INFERIEURE;42811;8230;4834;12522;2443;70840;10827;0;9794;3394;33540;128395;0;76;;list(c(540079.821237026, 563698.753605279, 589222.822291426, 574388.882972505, 543350.122639953, 540079.821237026, 6927415.29044812, 6953982.22394851, 6933347.99343274, 6918071.93195382, 6912837.51371804, 6927415.29044812))
121;821;CASTEL SARRASIN;TARN ET GARONNE;41727;3373;1393;5185;25454;77132;7401;15106;3;3297;18557;121496;0;82;;list(c(531409.348844173, 551829.327828515, 549211.294021104, 543708.600505248, 536480.161400756, 520309.373779033, 531409.348844173, 6350660.18942488, 6320006.14669177, 6300534.85297207, 6296616.16876499, 6297392.84495693, 6333565.74538587, 6350660.18942488))
122;245;SARLAT;DORDOGNE;43768;9154;1189;3383;5618;63112;9196;19453;22343;23017;57244;194365;2155;24;;list(c(529151.181038929, 551923.714820828, 581478.681098411, 539592.341813388, 531227.694618586, 529151.181038929, 6429759.92784062, 6455777.02802237, 6426977.19919367, 6397792.42268526, 6403626.44225352, 6429759.92784062))
123;274;LOUVIERS;EURE;29567;4749;2376;5462;5620;47774;2289;161;2926;1509;23852;78511;3;27;;list(c(543350.122639953, 574388.882972505, 576479.228418473, 546166.170387642, 541676.558822682, 543350.122639953, 6912837.51371804, 6918071.93195382, 6891818.76663964, 6894059.10106384, 6907863.71806547, 6912837.51371804))
124;874;SAINT YRIEIX;HAUTE VIENNE;19944;2388;1008;270;9271;32881;23164;5;14161;7054;13468;90733;0;87;;list(c(538665.608093716, 539905.578574404, 548943.095050374, 588322.45014638, 597025.182219123, 580176.825751777, 552581.918654435, 538665.608093716, 6477004.61681662, 6505634.5539962, 6512723.86717678, 6509868.88209173, 6501659.86042914, 6476869.02413168, 6461754.371746, 6477004.61681662))
125;284;NOGENT LE ROTROU;EURE ET LOIR;31699;372;981;12139;14284;59475;6528;52;5;1363;15303;82726;174;28;;list(c(522202.67219352, 554267.184888453, 559473.579564237, 565565.599254409, 549128.326127473, 518034.275559666, 522202.67219352, 6812361.81626461, 6831397.96004846, 6826730.92183757, 6802496.23811965, 6780865.59989624, 6785262.46008274, 6812361.81626461))
126;822;MOISSAC;TARN ET GARONNE;35477;3176;837;6321;13489;59300;4206;8853;5;4479;13749;90592;0;82;;list(c(548640.069233886, 568846.792301871, 551829.327828515, 531409.348844173, 531905.067275792, 548640.069233886, 6366077.47591139, 6350692.73268922, 6320006.14669177, 6350660.18942488, 6352548.70476744, 6366077.47591139))
127;311;MURET;HAUTE GARONNE;61167;5557;2234;9323;27554;105835;6609;16969;94;4196;29534;163237;0;31;;list(c(548148.237887701, 579635.615614297, 577408.574494733, 561131.981165032, 543488.122167133, 548148.237887701, 6283004.37663581, 6262894.58766337, 6245886.15679473, 6234283.76400994, 6238512.61384916, 6283004.37663581))
128;871;BELLAC;HAUTE VIENNE;35289;5203;1951;625;41948;85016;51741;1522;5873;20651;16121;180924;2500;87;;list(c(528709.551263936, 556142.451578826, 579220.104603168, 577847.381894748, 546791.102827548, 536049.443946363, 528709.551263936, 6572114.35984989, 6579396.04905343, 6559796.90579463, 6555665.6321746, 6539484.45111193, 6544914.53671172, 6572114.35984989))
129;313;TOULOUSE;HAUTE GARONNE;59353;6467;3192;10621;23075;102708;8347;21803;43;5143;21290;159334;0;31;;list(c(549211.294021104, 582767.947879991, 591589.291113405, 579635.615614297, 548148.237887701, 543708.600505248, 549211.294021104, 6300534.85297207, 6303783.05361863, 6275241.19390729, 6262894.58766337, 6283004.37663581, 6296616.16876499, 6300534.85297207))
130;413;VENDOME;LOIR ET CHER;80545;1939;1740;15774;27754;127752;8974;3911;192;3909;26955;171693;15;41;;list(c(553076.104763499, 584260.382183978, 545514.995329655, 528932.706823578, 553076.104763499, 6768971.64126621, 6748249.0727361, 6720799.04380286, 6731658.12254011, 6768971.64126621))
131;273;EVREUX;EURE;83330;6376;3492;26808;18612;138618;4773;832;10432;4627;51639;210921;12;27;;list(c(546166.170387642, 576479.228418473, 585507.270836347, 583966.43243538, 545971.531723993, 538120.05664227, 546166.170387642, 6894059.10106384, 6891818.76663964, 6883880.25014383, 6872417.60779562, 6853312.30114963, 6859596.04201104, 6894059.10106384))
132;283;DREUX;EURE ET LOIR;57961;2310;2129;25939;19838;108177;4106;1775;44;1932;34914;150948;0;28;;list(c(545971.531723993, 583966.43243538, 599880.118272849, 594040.8780318, 559473.579564237, 554267.184888453, 545971.531723993, 6853312.30114963, 6872417.60779562, 6855495.42051477, 6837192.29176425, 6826730.92183757, 6831397.96004846, 6853312.30114963))
133;282;CHATEAUDUN;EURE ET LOIR;78607;1663;1365;22690;19026;123351;4050;662;53;1520;14969;144605;1037;28;;list(c(549128.326127473, 565565.599254409, 608642.025666039, 608674.215855307, 588231.16413911, 584260.382183978, 553076.104763499, 549128.326127473, 6780865.59989624, 6802496.23811965, 6787474.5620265, 6787271.95753906, 6748078.00198928, 6748249.0727361, 6768971.64126621, 6780865.59989624))
134;411;BLOIS;LOIR ET CHER;101598;4042;2323;22211;27017;157191;9852;19391;31;11438;55321;253224;2324;41;;list(c(545514.995329655, 584260.382183978, 588231.16413911, 602155.793179794, 573426.693227473, 554840.120129819, 545514.995329655, 6720799.04380286, 6748249.0727361, 6748078.00198928, 6727797.99018825, 6689064.98175424, 6698706.38056573, 6720799.04380286))
135;361;LE BLANC;INDRE;50780;2084;2416;5029;30451;90760;24352;4451;23;25788;38688;184062;9736;36;;list(c(542123.231743148, 569111.887096543, 580584.16350171, 557726.640716775, 529129.43925615, 542123.231743148, 6642725.91126385, 6646633.70186804, 6616848.347738, 6597378.91487076, 6617769.72908895, 6642725.91126385))
136;463;GOURDON;LOT;54730;5290;1261;1739;10434;73454;6222;11660;6263;19861;31147;148607;32;46;;list(c(539592.341813388, 581478.681098411, 603700.950828023, 595377.842828874, 547581.000889487, 539592.341813388, 6397792.42268526, 6426977.19919367, 6420961.34131707, 6393280.38277392, 6386075.68599728, 6397792.42268526))
137;872;LIMOGES;HAUTE VIENNE;45612;3152;2181;541;24281;75767;47000;730;26974;33717;15967;200155;2824;87;;list(c(577847.381894748, 588322.45014638, 548943.095050374, 546791.102827548, 577847.381894748, 6555665.6321746, 6509868.88209173, 6512723.86717678, 6539484.45111193, 6555665.6321746))
138;363;LA CHATRE;INDRE;39065;2135;1953;4452;25565;73170;28399;2075;2475;8145;17800;132064;12;36;;list(c(557726.640716775, 580584.16350171, 609832.713107273, 609238.801440796, 582881.93978446, 579220.104603168, 556142.451578826, 557726.640716775, 6597378.91487076, 6616848.347738, 6600833.39835899, 6595776.8706705, 6561685.42527681, 6559796.90579463, 6579396.04905343, 6597378.91487076))
139;362;CHATEAUROUX;INDRE;79704;2232;2214;8747;40549;133446;26801;5683;126;26070;53402;245528;3385;36;;list(c(569111.887096543, 583313.792577659, 596927.061481399, 628968.705035615, 609832.713107273, 580584.16350171, 569111.887096543, 6646633.70186804, 6667410.76593976, 6666429.81900907, 6615859.47761687, 6600833.39835899, 6616848.347738, 6646633.70186804))
140;823;MONTAUBAN;TARN ET GARONNE;52476;5655;1521;8726;25053;93431;7146;14008;882;10070;34391;159928;20;82;;list(c(551829.327828515, 568846.792301871, 593528.828832784, 596801.518571869, 585876.432545542, 582767.947879991, 549211.294021104, 551829.327828515, 6320006.14669177, 6350692.73268922, 6347148.0069558, 6342160.21045246, 6306734.8513958, 6303783.05361863, 6300534.85297207, 6320006.14669177))
141;191;BRIVE;CORREZE;38832;6902;1247;948;8668;56597;22069;15391;27335;13242;17723;152357;244;19;;list(c(552581.918654435, 580176.825751777, 613352.510515021, 603700.950828023, 581478.681098411, 551923.714820828, 552581.918654435, 6461754.371746, 6476869.02413168, 6427230.38772068, 6420961.34131707, 6426977.19919367, 6455777.02802237, 6461754.371746))
142;092;PAMIERS;ARIEGE;43576;6262;1239;7024;16291;74392;3415;9217;57;13662;28109;128852;0;09;;list(c(561131.981165032, 577408.574494733, 599507.310288094, 612901.033062453, 611908.541286511, 568192.230007291, 561131.981165032, 6234283.76400994, 6245886.15679473, 6239592.00119166, 6221475.6329351, 6216271.92820009, 6218627.25152845, 6234283.76400994))
143;623;BOULOGNE;PAS DE CALAIS;29860;9650;2102;9567;7002;58181;14047;0;1675;6013;14244;94160;673;62;;list(c(623122.470326409, 625438.3437106, 599033.989105694, 598146.868084221, 599925.679873168, 610410.697747022, 621454.578517616, 623122.470326409, 7094424.23659404, 7063537.61812204, 7053209.43822105, 7067885.07893921, 7086873.93172694, 7094227.53092359, 7097218.35815382, 7094424.23659404))
144;763;NEUFCHATEL;SEINE INFERIEURE;49177;3458;984;16756;13431;83806;13212;0;9024;3330;45174;154546;85;76;;list(c(563112.48766249, 589914.915746045, 618097.018792092, 621435.192284573, 602223.888671675, 589222.822291426, 563698.753605279, 563112.48766249, 6956285.31511534, 6990277.22975543, 6970629.57519963, 6958457.4376609, 6932674.13399573, 6933347.99343274, 6953982.22394851, 6956285.31511534))
145;271;LES ANDELYS;EURE;40602;5508;2376;14416;6919;69821;2628;143;3438;2219;26081;104330;70;27;;list(c(602223.888671675, 614229.42671934, 612580.788219697, 585507.270836347, 576479.228418473, 574388.882972505, 589222.822291426, 602223.888671675, 6932674.13399573, 6905995.06681119, 6902426.07695888, 6883880.25014383, 6891818.76663964, 6918071.93195382, 6933347.99343274, 6932674.13399573))
146;461;CAHORS;LOT;72048;6558;2072;2618;15756;99052;5208;36098;1489;20775;53776;216398;83;46;;list(c(547581.000889487, 595377.842828874, 601389.338759655, 593528.828832784, 568846.792301871, 548640.069233886, 547581.000889487, 6386075.68599728, 6393280.38277392, 6375674.48005842, 6347148.0069558, 6350692.73268922, 6366077.47591139, 6386075.68599728))
147;232;BOURGANEUF;CREUSE;15671;1672;648;230;10369;28590;18963;0;4326;22356;16358;90593;681;23;;list(c(579220.104603168, 582881.93978446, 619400.798918052, 618957.972793629, 607532.186930943, 597025.182219123, 588322.45014638, 577847.381894748, 579220.104603168, 6559796.90579463, 6561685.42527681, 6546129.39186368, 6512562.8243127, 6501708.41429055, 6501659.86042914, 6509868.88209173, 6555665.6321746, 6559796.90579463))
148;314;VILLEFRANCHE;HAUTE GARONNE;45191;3213;842;8908;15951;74105;2987;5543;4;1159;9816;93614;0;31;;list(c(591589.291113405, 614533.586690199, 599507.310288094, 577408.574494733, 579635.615614297, 591589.291113405, 6275241.19390729, 6269285.45184377, 6239592.00119166, 6245886.15679473, 6262894.58766337, 6275241.19390729))
149;281;CHARTRES;EURE ET LOIR;118153;4923;2561;39031;21284;185952;2919;1829;141;991;17319;209151;50;28;;list(c(594040.8780318, 611968.68745977, 609792.267413878, 608642.025666039, 565565.599254409, 559473.579564237, 594040.8780318, 6837192.29176425, 6817482.74346898, 6789541.05921898, 6787474.5620265, 6802496.23811965, 6826730.92183757, 6837192.29176425))
150;814;LAVAUR;TARN;36198;1413;724;5048;14407;57790;3608;7020;6;1139;11543;81106;0;81;;list(c(582767.947879991, 585876.432545542, 622001.825993218, 624443.214931411, 618001.447036592, 614533.586690199, 591589.291113405, 582767.947879991, 6303783.05361863, 6306734.8513958, 6297140.43043617, 6294706.21944628, 6270235.8599041, 6269285.45184377, 6275241.19390729, 6303783.05361863))
151;453;ORLEANS;LOIRET;70601;5521;2644;22922;26997;128685;9929;21743;165;15836;65698;242056;288;45;;list(c(588231.16413911, 608674.215855307, 650526.355721652, 638819.52698988, 602155.793179794, 588231.16413911, 6748078.00198928, 6787271.95753906, 6755623.14148451, 6718539.79430295, 6727797.99018825, 6748078.00198928))
152;412;ROMORANTIN;LOIR ET CHER;72519;1925;2529;946;35243;113162;9587;2290;565;45912;38659;210175;2855;41;;list(c(573426.693227473, 602155.793179794, 638819.52698988, 645844.864673958, 628524.664121251, 596927.061481399, 583313.792577659, 573426.693227473, 6689064.98175424, 6727797.99018825, 6718539.79430295, 6705376.94157404, 6679545.4207766, 6666429.81900907, 6667410.76593976, 6689064.98175424))
153;462;FIGEAC;LOT;42119;4139;1460;1641;15807;65166;13285;8338;26424;19949;23006;156168;4;46;;list(c(613352.510515021, 617605.383145973, 653421.208098732, 652531.183473744, 643871.746076306, 601389.338759655, 595377.842828874, 603700.950828023, 613352.510515021, 6427230.38772068, 6428338.69265584, 6394461.98442643, 6389336.60771878, 6375912.15620187, 6375674.48005842, 6393280.38277392, 6420961.34131707, 6427230.38772068))
154;783;MANTES;SEINE ET OISE;34189;4211;1966;11727;9847;61940;2405;2349;230;2069;18702;87695;84;78;;list(c(585507.270836347, 612580.788219697, 622262.222935154, 616031.586290658, 599880.118272849, 583966.43243538, 585507.270836347, 6883880.25014383, 6902426.07695888, 6868844.90850192, 6859331.18970123, 6855495.42051477, 6872417.60779562, 6883880.25014383))
155;091;FOIX;ARIEGE;26697;8778;953;1563;8192;46183;12172;1645;26;69293;81143;210462;0;09;;list(c(568192.230007291, 611908.541286511, 616778.080539632, 601133.318479367, 600207.174625772, 580936.08224819, 569831.397772294, 567601.779706067, 568192.230007291, 6218627.25152845, 6216271.92820009, 6183699.03516822, 6158181.00335885, 6164537.62114363, 6173958.52684225, 6174021.20972318, 6177659.06622173, 6218627.25152845))
156;112;CASTELNAUDARY;AUDE;40622;2051;547;6611;9256;59087;1690;4758;8;11044;13183;89770;0;11;;list(c(599507.310288094, 614533.586690199, 618001.447036592, 637589.250644801, 628018.622303343, 612901.033062453, 599507.310288094, 6239592.00119166, 6269285.45184377, 6270235.8599041, 6256100.70522608, 6232682.38408633, 6221475.6329351, 6239592.00119166))
157;454;PITHIVIERS;LOIRET;56379;2449;2037;16574;18699;96138;1785;8812;0;490;13019;120244;0;45;;list(c(608642.025666039, 609792.267413878, 655304.810469762, 669463.821766967, 650535.328879, 650526.355721652, 608674.215855307, 608642.025666039, 6787474.5620265, 6789541.05921898, 6806416.14100194, 6789412.39709086, 6755628.50795578, 6755623.14148451, 6787271.95753906, 6787474.5620265))
158;784;PONTOISE;SEINE ET OISE;48744;6952;5222;11157;8225;80300;3207;2878;982;720;23232;111319;1030;78;;list(c(614229.42671934, 639665.506032056, 648058.475578101, 652398.519303297, 636563.198172731, 622262.222935154, 612580.788219697, 614229.42671934, 6905995.06681119, 6905331.67289921, 6899692.16719917, 6890757.90390703, 6870222.92988407, 6868844.90850192, 6902426.07695888, 6905995.06681119))
159;192;TULLE;CORREZE;59124;4049;1532;218;20693;85616;32380;1349;42994;76037;18364;256740;6966;19;;list(c(597025.182219123, 607532.186930943, 626940.31722842, 621267.187691962, 617605.383145973, 613352.510515021, 580176.825751777, 597025.182219123, 6501659.86042914, 6501708.41429055, 6475761.16232004, 6433362.19765497, 6428338.69265584, 6427230.38772068, 6476869.02413168, 6501659.86042914))
160;594;DUNKERQUE;NORD;25394;10709;4742;3710;1852;46407;14200;0;0;3136;8417;72160;207;59;;list(c(661164.321322389, 623122.470326409, 621454.578517616, 635938.078892583, 668082.883965268, 674147.916683206, 673454.830737451, 661164.321322389, 7086527.26418645, 7094424.23659404, 7097218.35815382, 7101140.67932064, 7110478.77121413, 7094524.91120327, 7091563.43845591, 7086527.26418645))
161;624;MONTREUIL;PAS DE CALAIS;41283;10888;2435;9153;13261;77020;8754;0;4388;2662;19681;112505;464;62;;list(c(625438.3437106, 636724.588037367, 630310.748081368, 595019.243790654, 596754.502018977, 603526.969928824, 597212.913456084, 599270.39324492, 599033.989105694, 625438.3437106, 7063537.61812204, 7051643.75061126, 7023052.61655074, 7020097.65507783, 7029654.77923422, 7028674.52834186, 7034206.30517417, 7049298.60516942, 7053209.43822105, 7063537.61812204))
162;625;SAINT OMER;PAS DE CALAIS;45050;14998;3096;7305;11812;82261;9050;0;118;2668;14196;108293;630;62;;list(c(623122.470326409, 661164.321322389, 652937.736798433, 636724.588037367, 625438.3437106, 623122.470326409, 7094424.23659404, 7086527.26418645, 7053861.65112071, 7051643.75061126, 7063537.61812204, 7094424.23659404))
163;231;AUBUSSON;CREUSE;54324;6125;1462;427;33368;95706;42958;0;106;42085;23202;204057;845;23;;list(c(619400.798918052, 635312.841705532, 654347.641059683, 673534.454017067, 672325.284698499, 670630.844289324, 618957.972793629, 619400.798918052, 6546129.39186368, 6561452.66521402, 6559557.97530839, 6544557.89848526, 6530257.07934645, 6523427.20860554, 6512562.8243127, 6546129.39186368))
164;234;GUERET;CREUSE;44796;5356;1745;163;30403;82463;43280;0;3896;16882;20174;166695;159;23;;list(c(609238.801440796, 635312.841705532, 619400.798918052, 582881.93978446, 609238.801440796, 6595776.8706705, 6561452.66521402, 6546129.39186368, 6561685.42527681, 6595776.8706705))
165;813;GAILLAC;TARN;38707;6182;1366;5322;18724;70301;5164;16635;547;5211;29342;127200;0;81;;list(c(596801.518571869, 618633.231848629, 622001.825993218, 585876.432545542, 596801.518571869, 6342160.21045246, 6336805.0437412, 6297140.43043617, 6306734.8513958, 6342160.21045246))
166;125;VILLEFRANCHE;AVEYRON;34074;6044;1415;1871;22583;65987;12282;6891;14894;10822;18224;129100;0;12;;list(c(593528.828832784, 601389.338759655, 643871.746076306, 644640.515714565, 618633.231848629, 596801.518571869, 593528.828832784, 6347148.0069558, 6375674.48005842, 6375912.15620187, 6341094.05657351, 6336805.0437412, 6342160.21045246, 6347148.0069558))
167;364;ISSOUDUN;INDRE;50660;1178;916;6081;19561;78396;10162;5630;16;4610;19062;117876;350;36;;list(c(596927.061481399, 628524.664121251, 646781.669722205, 630049.277677141, 628968.705035615, 596927.061481399, 6666429.81900907, 6679545.4207766, 6642010.12141521, 6616113.50920982, 6615859.47761687, 6666429.81900907))
168;785;RAMBOUILLET;SEINE ET OISE;50617;2995;3313;13506;11669;82100;5351;1453;229;2546;40880;132559;125;78;;list(c(599880.118272849, 616031.586290658, 634753.022288443, 611968.68745977, 594040.8780318, 599880.118272849, 6855495.42051477, 6859331.18970123, 6835161.7674578, 6817482.74346898, 6837192.29176425, 6855495.42051477))
169;233;BOUSSAC;CREUSE;30865;2179;557;370;23086;57057;20929;0;834;4329;12336;95485;0;23;;list(c(609832.713107273, 628968.705035615, 630049.277677141, 655519.720905101, 654347.641059683, 635312.841705532, 609238.801440796, 609832.713107273, 6600833.39835899, 6615859.47761687, 6616113.50920982, 6602031.80915588, 6559557.97530839, 6561452.66521402, 6595776.8706705, 6600833.39835899))
170;801;ABBEVILLE;SOMME;65900;12156;9102;13348;21235;121741;4325;0;4837;5260;22306;158469;2235;80;;list(c(586022.515636499, 593645.08199376, 595019.243790654, 630310.748081368, 633253.132508758, 636022.647936874, 618097.018792092, 589914.915746045, 586022.515636499, 7000736.29682029, 7012529.3089438, 7020097.65507783, 7023052.61655074, 7019434.69305232, 6994764.80176806, 6970629.57519963, 6990277.22975543, 7000736.29682029))
171;601;BEAUVAIS;OISE;79698;3734;3486;27556;23385;137859;13590;592;1248;4044;36565;193898;2083;60;;list(c(642376.07066771, 650541.866378118, 639665.506032056, 614229.42671934, 602223.888671675, 621435.192284573, 642376.07066771, 6952355.11230858, 6939719.60855214, 6905331.67289921, 6905995.06681119, 6932674.13399573, 6958457.4376609, 6952355.11230858))
172;802;AMIENS;SOMME;86023;8242;7172;18313;27367;147117;5093;0;1824;2666;23250;179950;274;80;;list(c(621435.192284573, 618097.018792092, 636022.647936874, 671068.624705649, 671986.965603017, 642376.07066771, 621435.192284573, 6958457.4376609, 6970629.57519963, 6994764.80176806, 6988477.96865938, 6973517.98813843, 6952355.11230858, 6958457.4376609))
173;782;ETAMPES;SEINE ET OISE;35845;3682;810;9753;9926;60016;2263;1901;458;1560;13821;80019;0;78;;list(c(611968.68745977, 634753.022288443, 636244.040474541, 636346.590401315, 655336.076130163, 655304.810469762, 609792.267413878, 611968.68745977, 6817482.74346898, 6835161.7674578, 6835124.43366262, 6835089.61635933, 6812102.59347214, 6806416.14100194, 6789541.05921898, 6817482.74346898))
174;812;CASTRES;TARN;56171;7225;1728;5031;49416;119571;21803;5207;817;32575;43031;223004;314;81;;list(c(618001.447036592, 624443.214931411, 659877.301270814, 667257.305769692, 654622.069774431, 637589.250644801, 618001.447036592, 6270235.8599041, 6294706.21944628, 6303466.02278943, 6293893.37693816, 6259138.69780876, 6256100.70522608, 6270235.8599041))
175;811;ALBI;TARN;34886;4896;1408;4842;31188;77220;11857;8718;8158;13097;23856;142906;0;81;;list(c(622001.825993218, 618633.231848629, 644640.515714565, 658583.633377918, 659877.301270814, 624443.214931411, 622001.825993218, 6297140.43043617, 6336805.0437412, 6341094.05657351, 6330701.63716303, 6303466.02278943, 6294706.21944628, 6297140.43043617))
176;113;LIMOUX;AUDE;33441;5100;919;11576;20010;71046;5662;9794;142;50639;44727;182010;0;11;;list(c(612901.033062453, 628018.622303343, 672496.62793359, 673073.814599288, 666260.338528975, 616778.080539632, 611908.541286511, 612901.033062453, 6221475.6329351, 6232682.38408633, 6211224.37322313, 6207895.65068587, 6198492.18006971, 6183699.03516822, 6216271.92820009, 6221475.6329351))
177;786;VERSAILLES;SEINE ET OISE;22296;6773;7686;6440;1476;44671;4178;7695;873;807;26544;84768;0;78;;list(c(622262.222935154, 636563.198172731, 641991.773019562, 643081.194042643, 636244.040474541, 634753.022288443, 616031.586290658, 622262.222935154, 6868844.90850192, 6870222.92988407, 6864122.23303657, 6861049.76000155, 6835124.43366262, 6835161.7674578, 6859331.18970123, 6868844.90850192))
178;193;USSEL;CORREZE;38970;2578;313;529;14590;56980;18697;0;1586;72073;28176;177512;1946;19;;list(c(618957.972793629, 670630.844289324, 682005.395424673, 681830.249825439, 674192.691049544, 626940.31722842, 607532.186930943, 618957.972793629, 6512562.8243127, 6523427.20860554, 6495138.42956215, 6484925.87463021, 6478036.88569007, 6475761.16232004, 6501708.41429055, 6512562.8243127))
179;151;AURILLAC;CANTAL;30485;1581;1244;655;21402;55367;60695;236;12942;36204;28792;194236;1264;15;;list(c(617605.383145973, 621267.187691962, 665673.731637716, 683239.82511182, 684905.724042514, 653421.208098732, 617605.383145973, 6428338.69265584, 6433362.19765497, 6445955.98154534, 6419672.7709827, 6411859.93741413, 6394461.98442643, 6428338.69265584))
180;181;BOURGES;CHER;84289;3620;2258;22143;35074;147384;35299;7150;57;3509;52549;245948;237;18;;list(c(645844.864673958, 647756.606695548, 683803.729125883, 681540.335423412, 646781.669722205, 628524.664121251, 645844.864673958, 6705376.94157404, 6704815.83729879, 6662214.9252252, 6649718.45184847, 6642010.12141521, 6679545.4207766, 6705376.94157404))
181;803;DOULLENS;SOMME;28705;2257;8787;7161;8305;55215;485;0;1388;925;7845;65858;210;80;;list(c(633253.132508758, 665747.440180114, 676701.578293771, 671068.624705649, 636022.647936874, 633253.132508758, 7019434.69305232, 7019159.05896982, 6997632.82542095, 6988477.96865938, 6994764.80176806, 7019434.69305232))
182;753;SCEAUX;SEINE;7749;3026;2703;1966;160;15604;786;1463;135;222;5707;23917;0;75;;list(c(643081.194042643, 665778.217802246, 636346.590401315, 636244.040474541, 643081.194042643, 6861049.76000155, 6849766.88520419, 6835089.61635933, 6835124.43366262, 6861049.76000155))
183;752;SAINT DENIS;SEINE;5086;4759;1363;881;0;12089;365;1288;0;0;6467;20209;0;75;;list(c(636563.198172731, 652398.519303297, 671134.323135053, 671794.806216704, 641991.773019562, 636563.198172731, 6870222.92988407, 6890757.90390703, 6879207.98578101, 6870391.21328663, 6864122.23303657, 6870222.92988407))
184;451;GIEN;LOIRET;55733;1876;2667;7966;24884;93126;7519;2605;184;8871;34854;147159;120;45;;list(c(638819.52698988, 650526.355721652, 650535.328879, 705980.041223249, 709245.920575587, 710147.494791692, 674472.997986393, 647756.606695548, 645844.864673958, 638819.52698988, 6718539.79430295, 6755623.14148451, 6755628.50795578, 6746148.8014904, 6740577.90694345, 6733402.56218073, 6711788.52346425, 6704815.83729879, 6705376.94157404, 6718539.79430295))
185;662;PERPIGNAN;PYRENEES ORIENTALES;20082;3227;991;5713;15445;45458;1900;27935;3374;43899;14507;137073;1034;66;;list(c(673073.814599288, 704293.542383308, 703588.002294897, 703356.25580446, 672894.443744574, 666260.338528975, 673073.814599288, 6207895.65068587, 6201305.04800571, 6193185.62217565, 6156740.95751159, 6171562.68776639, 6198492.18006971, 6207895.65068587))
186;123;RODEZ;AVEYRON;47099;8279;1554;1564;44306;102802;30460;3755;22759;40668;26578;227022;18;12;;list(c(643871.746076306, 652531.183473744, 692242.674088737, 685060.529733221, 658583.633377918, 644640.515714565, 643871.746076306, 6375912.15620187, 6389336.60771878, 6354812.50253339, 6344017.73675177, 6330701.63716303, 6341094.05657351, 6375912.15620187))
187;152;MAURIAC;CANTAL;23557;1211;796;335;10780;36679;58515;0;633;9541;22870;128238;938;15;;list(c(626940.31722842, 674192.691049544, 665673.731637716, 621267.187691962, 626940.31722842, 6475761.16232004, 6478036.88569007, 6445955.98154534, 6433362.19765497, 6475761.16232004))
188;111;CARCASSONNE;AUDE;52609;3855;728;8559;27561;93312;4569;18119;1511;60594;24380;202485;0;11;;list(c(637589.250644801, 654622.069774431, 675557.887056477, 672496.62793359, 628018.622303343, 637589.250644801, 6256100.70522608, 6259138.69780876, 6236577.90455852, 6211224.37322313, 6232682.38408633, 6256100.70522608))
189;032;MONTLUCON;ALLIER;84375;3621;1520;2919;56760;149195;20138;3703;576;3120;32182;208914;843;03;;list(c(655519.720905101, 691647.741044413, 701549.0307358, 678868.355284818, 673534.454017067, 654347.641059683, 655519.720905101, 6602031.80915588, 6607804.15176365, 6585076.74230379, 6548833.12444626, 6544557.89848526, 6559557.97530839, 6602031.80915588))
190;781;CORBEIL;SEINE ET OISE;24244;3746;5617;6112;3246;42965;2370;4128;232;510;13799;64004;0;78;;list(c(665778.217802246, 673759.397236926, 661732.209320344, 655336.076130163, 636346.590401315, 665778.217802246, 6849766.88520419, 6851242.34316627, 6818351.75402402, 6812102.59347214, 6835089.61635933, 6849766.88520419))
191;751;PARIS;SEINE;0;0;302;0;0;302;0;0;0;0;3122;3424;0;75;;list(c(643081.194042643, 641991.773019562, 671794.806216704, 676393.737969799, 673759.397236926, 665778.217802246, 643081.194042643, 6861049.76000155, 6864122.23303657, 6870391.21328663, 6852915.31068641, 6851242.34316627, 6849766.88520419, 6861049.76000155))
192;182;SAINT AMAND;CHER;57353;2900;2102;28439;39589;130383;63069;993;816;2990;67326;265577;537;18;;list(c(630049.277677141, 646781.669722205, 681540.335423412, 696538.670029302, 691647.741044413, 655519.720905101, 630049.277677141, 6616113.50920982, 6642010.12141521, 6649718.45184847, 6624306.01099604, 6607804.15176365, 6602031.80915588, 6616113.50920982))
193;153;MURAT;CANTAL;11590;650;269;165;4821;17495;50605;0;12;6584;10628;85324;135;15;;list(c(674192.691049544, 681830.249825439, 702536.672668285, 708012.674493614, 683239.82511182, 665673.731637716, 674192.691049544, 6478036.88569007, 6484925.87463021, 6471252.33847335, 6459351.44032491, 6419672.7709827, 6445955.98154534, 6478036.88569007))
194;626;SAINT POL;PAS DE CALAIS;48811;13210;7007;10735;13742;93505;3177;0;1848;524;14769;113823;61;62;;list(c(652937.736798433, 654428.874267712, 670543.397020764, 665747.440180114, 633253.132508758, 630310.748081368, 636724.588037367, 652937.736798433, 7053861.65112071, 7053332.42924854, 7031935.24273179, 7019159.05896982, 7019434.69305232, 7023052.61655074, 7051643.75061126, 7053861.65112071))
195;604;SENLIS;OISE;51441;4805;3265;17981;14235;91727;4166;373;674;2687;33147;132774;574;60;;list(c(648058.475578101, 673522.78034797, 694905.342265365, 671134.323135053, 652398.519303297, 648058.475578101, 6899692.16719917, 6918015.75389771, 6897961.45348562, 6879207.98578101, 6890757.90390703, 6899692.16719917))
196;602;CLERMONT;OISE;60029;5977;3665;19255;13902;102828;3355;303;1300;2079;20126;129991;0;60;;list(c(639665.506032056, 650541.866378118, 672564.975496247, 673522.78034797, 648058.475578101, 639665.506032056, 6905331.67289921, 6939719.60855214, 6931233.34452451, 6918015.75389771, 6899692.16719917, 6905331.67289921))
197;124;SAINT AFFRIQUE;AVEYRON;27983;4008;533;7055;25679;65258;17318;3011;6152;44065;35479;171283;0;12;;list(c(659877.301270814, 658583.633377918, 685060.529733221, 709894.042195508, 694974.167777888, 667257.305769692, 659877.301270814, 6303466.02278943, 6330701.63716303, 6344017.73675177, 6310442.57743361, 6289439.92529716, 6293893.37693816, 6303466.02278943))
198;804;MONTDIDIER;SOMME;46275;4045;3661;12830;8699;75510;1867;0;701;994;12423;91495;66;80;;list(c(671986.965603017, 698655.288412752, 698705.042670026, 672564.975496247, 650541.866378118, 642376.07066771, 671986.965603017, 6973517.98813843, 6951081.21261766, 6950966.00062085, 6931233.34452451, 6939719.60855214, 6952355.11230858, 6973517.98813843))
199;596;LILLE;NORD;33586;13712;11129;6294;3570;68291;6124;0;1398;238;11388;87439;456;59;;list(c(692983.92727952, 685024.452699137, 686576.833979183, 686823.977462781, 710483.77389678, 720341.029466397, 721057.64804447, 692983.92727952, 7043611.86678353, 7063915.00821894, 7069209.81071484, 7068960.52109821, 7077087.87954363, 7047882.69502747, 7047430.53610931, 7043611.86678353))
200;595;HAZEBROUCK;NORD;21503;12205;3645;3321;1926;42600;18013;0;0;77;8630;69320;0;59;;list(c(652937.736798433, 661164.321322389, 673454.830737451, 671728.509233873, 686576.833979183, 685024.452699137, 654428.874267712, 652937.736798433, 7053861.65112071, 7086527.26418645, 7091563.43845591, 7084187.074648, 7069209.81071484, 7063915.00821894, 7053332.42924854, 7053861.65112071))
201;772;FONTAINEBLEAU;SEINE ET MARNE;42319;3548;1216;13341;22205;82629;3642;7325;61;2620;26304;122581;420;77;;list(c(655336.076130163, 661732.209320344, 697992.106871535, 703386.542463301, 694290.900129488, 669463.821766967, 655304.810469762, 655336.076130163, 6812102.59347214, 6818351.75402402, 6823586.9903591, 6808060.40983033, 6791556.31710441, 6789412.39709086, 6806416.14100194, 6812102.59347214))
202;121;ESPALION;AVEYRON;25326;2273;518;1130;20917;50164;35957;2973;12760;27378;24666;153898;2850;12;;list(c(653421.208098732, 684905.724042514, 699758.485228613, 703914.069575587, 692242.674088737, 652531.183473744, 653421.208098732, 6394461.98442643, 6411859.93741413, 6405347.13983458, 6361872.92449235, 6354812.50253339, 6389336.60771878, 6394461.98442643))
203;344;SAINT PONS;HERAULT;14462;1911;248;1653;10853;29127;5488;7566;7657;51851;20016;121705;0;34;;list(c(667257.305769692, 694974.167777888, 705288.700929883, 696380.248600757, 675557.887056477, 654622.069774431, 667257.305769692, 6293893.37693816, 6289439.92529716, 6272929.42917662, 6249496.01385552, 6236577.90455852, 6259138.69780876, 6293893.37693816))
204;773;MEAUX;SEINE ET MARNE;52018;4580;3887;18901;12624;92010;7538;4645;1349;361;19768;125671;6;77;;list(c(671134.323135053, 694905.342265365, 703944.710662149, 711525.078166727, 682683.019465304, 676393.737969799, 671794.806216704, 671134.323135053, 6879207.98578101, 6897961.45348562, 6898599.89978044, 6874656.62527166, 6850407.79170678, 6852915.31068641, 6870391.21328663, 6879207.98578101))
205;622;BETHUNE;PAS DE CALAIS;40203;12325;12199;7805;8558;81090;2941;0;325;1021;8568;93945;3191;62;;list(c(654428.874267712, 685024.452699137, 692983.92727952, 690237.959189586, 670543.397020764, 654428.874267712, 7053332.42924854, 7063915.00821894, 7043611.86678353, 7038345.57480051, 7031935.24273179, 7053332.42924854))
206;774;MELUN;SEINE ET MARNE;36125;2449;5954;12290;14492;71310;3801;4274;236;2418;26484;108523;87;77;;list(c(673759.397236926, 676393.737969799, 682683.019465304, 697458.633276793, 697992.106871535, 661732.209320344, 673759.397236926, 6851242.34316627, 6852915.31068641, 6850407.79170678, 6834385.31530475, 6823586.9903591, 6818351.75402402, 6851242.34316627))
207;632;CLERMONT;PUY DE DOME;52662;8261;2901;8039;17759;89622;17621;14065;1946;34342;20035;177631;834;63;;list(c(672325.284698499, 725247.388900588, 728537.106289405, 682005.395424673, 670630.844289324, 672325.284698499, 6530257.07934645, 6525242.27716411, 6512955.73086071, 6495138.42956215, 6523427.20860554, 6530257.07934645))
208;183;SANCERRE;CHER;61661;2220;2720;19312;37032;122945;32162;2571;112;9351;41268;208409;419;18;;list(c(674472.997986393, 709537.86319715, 683803.729125883, 647756.606695548, 674472.997986393, 6711788.52346425, 6679671.74591435, 6662214.9252252, 6704815.83729879, 6711788.52346425))
209;805;PERONNE;SOMME;53441;7023;12493;15542;12188;100687;2289;0;697;1240;15435;120348;660;80;;list(c(676701.578293771, 695784.022781452, 711910.0956953, 698655.288412752, 671986.965603017, 671068.624705649, 676701.578293771, 6997632.82542095, 7002936.5526476, 6989656.24556411, 6951081.21261766, 6973517.98813843, 6988477.96865938, 6997632.82542095))
210;621;ARRAS;PAS DE CALAIS;60486;10723;32924;16742;4390;125265;1870;0;741;405;9557;137838;281;62;;list(c(670543.397020764, 690237.959189586, 700226.322764477, 695784.022781452, 676701.578293771, 665747.440180114, 670543.397020764, 7031935.24273179, 7038345.57480051, 7014458.51362662, 7002936.5526476, 6997632.82542095, 7019159.05896982, 7031935.24273179))
211;603;COMPIEGNE;OISE;45710;8519;5161;9905;7662;76957;7505;1017;525;1057;41783;128844;624;60;;list(c(672564.975496247, 698705.042670026, 708329.781068564, 704806.819192542, 703944.710662149, 694905.342265365, 673522.78034797, 672564.975496247, 6931233.34452451, 6950966.00062085, 6945040.90176444, 6899459.50822128, 6898599.89978044, 6897961.45348562, 6918015.75389771, 6931233.34452451))
212;593;DOUAI;NORD;20485;7757;5404;3840;1209;38695;1972;0;428;139;5972;47206;283;59;;list(c(692983.92727952, 721057.64804447, 722827.519256335, 721904.07282212, 714531.991750178, 700226.322764477, 690237.959189586, 692983.92727952, 7043611.86678353, 7047430.53610931, 7046313.81505724, 7030511.98465746, 7020756.97750385, 7014458.51362662, 7038345.57480051, 7043611.86678353))
213;452;MONTARGIS;LOIRET;63356;3005;2411;13457;35033;117262;8786;4694;7;1311;35599;167659;630;45;;list(c(650535.328879, 669463.821766967, 694290.900129488, 705456.090556873, 705980.041223249, 650535.328879, 6755628.50795578, 6789412.39709086, 6791556.31710441, 6769907.15754324, 6746148.8014904, 6755628.50795578))
214;584;NEVERS;NIEVRE;50302;5533;2362;13271;31900;103368;33046;2871;163;5177;82419;227044;358;58;;list(c(683803.729125883, 709537.86319715, 719799.350213018, 738806.693321397, 744644.233176312, 696538.670029302, 681540.335423412, 683803.729125883, 6662214.9252252, 6679671.74591435, 6683233.13891515, 6673520.61932951, 6637317.51409713, 6624306.01099604, 6649718.45184847, 6662214.9252252))
215;122;MILLAU;AVEYRON;39656;4895;550;7361;17785;70247;39329;2757;4713;50030;25954;193030;30;12;;list(c(692242.674088737, 703914.069575587, 722850.824961087, 733796.42849086, 726908.544592508, 709894.042195508, 685060.529733221, 692242.674088737, 6354812.50253339, 6361872.92449235, 6356859.05503639, 6338886.45383558, 6316408.7610247, 6310442.57743361, 6344017.73675177, 6354812.50253339))
216;205;SARTENE;CORSE;15344;224;471;0;13938;29977;131;1449;2331;32950;117496;184334;95;20;;list(c(1210922.31460489, 1232193.05293765, 1232179.83512018, 1231663.66140447, 1226741.01505485, 1221345.70199979, 1207963.27901189, 1183771.13642707, 1183760.95674267, 1176834.88783943, 1177535.18093458, 1210922.31460489, 6108595.07993149, 6107102.38692943, 6105892.09373763, 6076589.12124398, 6070390.23347857, 6050092.95545787, 6058231.30841748, 6068544.45185812, 6076761.9364324, 6086514.7070851, 6089163.36313405, 6108595.07993149))
217;114;NARBONNE;AUDE;36970;2351;310;4267;8189;52087;1889;30857;725;53179;18322;157059;1904;11;;list(c(672496.62793359, 675557.887056477, 696380.248600757, 718454.620385851, 705364.41897614, 704293.542383308, 673073.814599288, 672496.62793359, 6211224.37322313, 6236577.90455852, 6249496.01385552, 6233271.46974921, 6213628.80283052, 6201305.04800571, 6207895.65068587, 6211224.37322313))
218;583;COSNE;NIEVRE;40768;1469;1210;10989;15204;69640;11500;3519;140;2571;52806;140176;395;58;;list(c(710147.494791692, 714485.584707328, 719799.350213018, 709537.86319715, 674472.997986393, 710147.494791692, 6733402.56218073, 6728491.31862332, 6683233.13891515, 6679671.74591435, 6711788.52346425, 6733402.56218073))
219;154;SAINT FLOUR;CANTAL;41233;1367;476;480;22225;65781;55395;117;151;20975;23930;166349;60;15;;list(c(683239.82511182, 708012.674493614, 738228.36472037, 738415.54712523, 735455.187077141, 699758.485228613, 684905.724042514, 683239.82511182, 6419672.7709827, 6459351.44032491, 6434972.192408, 6418861.74927397, 6417049.7796463, 6405347.13983458, 6411859.93741413, 6419672.7709827))
220;893;JOIGNY;YONNE;50004;6690;2980;22188;34028;115890;8390;7362;139;2429;62486;196696;57;89;;list(c(705456.090556873, 752386.12629684, 759670.230313349, 754837.232528493, 709245.920575587, 705980.041223249, 705456.090556873, 6769907.15754324, 6787984.31643666, 6776737.05406416, 6765557.07735054, 6740577.90694345, 6746148.8014904, 6769907.15754324))
221;771;COULOMMIERS;SEINE ET MARNE;33242;2333;1520;11954;15406;64455;6600;2198;539;248;20376;94416;40;77;;list(c(682683.019465304, 711525.078166727, 737208.235278887, 697458.633276793, 682683.019465304, 6850407.79170678, 6874656.62527166, 6855063.59530044, 6834385.31530475, 6850407.79170678))
222;033;MOULINS;ALLIER;80116;3588;2471;7687;64239;158101;27036;3996;186;9175;59352;257846;352;03;;list(c(696538.670029302, 744644.233176312, 764515.322331833, 762375.444599244, 721136.040842439, 701549.0307358, 691647.741044413, 696538.670029302, 6624306.01099604, 6637317.51409713, 6621413.26596518, 6607611.46819427, 6580578.42600297, 6585076.74230379, 6607804.15176365, 6624306.01099604))
223;342;LODEVE;HERAULT;16723;1094;367;2044;9799;30027;1396;16340;3092;53979;14964;119798;0;34;;list(c(694974.167777888, 709894.042195508, 726908.544592508, 749608.080533733, 742451.755455239, 705288.700929883, 694974.167777888, 6289439.92529716, 6310442.57743361, 6316408.7610247, 6294641.96346368, 6268754.02841931, 6272929.42917662, 6289439.92529716))
224;023;SAINT QUENTIN;AISNE;49784;8366;8415;13932;4897;85394;2643;0;2094;1334;15812;107277;1017;02;;list(c(698655.288412752, 711910.0956953, 740063.043425578, 743591.171203241, 743141.532040944, 718198.860213128, 708329.781068564, 698705.042670026, 698655.288412752, 6951081.21261766, 6989656.24556411, 6991856.07191728, 6991337.88918668, 6965458.93947151, 6945684.71678529, 6945040.90176444, 6950966.00062085, 6951081.21261766))
225;775;PROVINS;SEINE ET MARNE;47844;2005;1779;17638;21292;90558;9100;2721;102;1667;18295;122443;648;77;;list(c(697458.633276793, 737208.235278887, 742051.611475847, 720960.689556409, 703386.542463301, 697992.106871535, 697458.633276793, 6834385.31530475, 6855063.59530044, 6854474.56276846, 6808743.16423698, 6808060.40983033, 6823586.9903591, 6834385.31530475))
226;131;ARLES;BOUCHES DU RHONE;26257;2230;6691;3904;16449;55531;4674;8899;10292;59577;90417;229390;12309;13;;list(c(801769.943583355, 831950.847866546, 863131.597650592, 863336.257723348, 850449.597106346, 850581.817513901, 828246.611214671, 824205.581630409, 800736.855147244, 801769.943583355, 6273502.61398826, 6297920.05364156, 6288315.3157262, 6266837.87415571, 6257858.32020906, 6249972.30374821, 6252708.49616569, 6262635.37265662, 6263128.41717945, 6273502.61398826))
227;343;MONTPELLIER;HERAULT;23639;875;800;5991;12163;43468;3687;29622;3847;55918;63173;199715;1014;34;;list(c(800736.855147244, 799600.812448661, 789016.478587015, 773396.307933032, 751837.466901461, 751335.394092751, 742451.755455239, 749608.080533733, 778139.364161717, 778335.069012103, 801769.943583355, 800736.855147244, 6263128.41717945, 6263152.28381877, 6273467.59759246, 6269095.53131716, 6253792.3496477, 6253202.18940438, 6268754.02841931, 6294641.96346368, 6308334.89605412, 6308278.07946608, 6273502.61398826, 6263128.41717945))
228;633;ISSOIRE;PUY DE DOME;43658;4937;1343;3667;30360;83965;23604;8355;1540;42049;23351;182864;268;63;;list(c(682005.395424673, 728537.106289405, 738686.622409032, 739237.369806996, 702536.672668285, 681830.249825439, 682005.395424673, 6495138.42956215, 6512955.73086071, 6506524.18791251, 6486079.15114682, 6471252.33847335, 6484925.87463021, 6495138.42956215))
229;634;RIOM;PUY DE DOME;70508;9646;2337;5118;50968;138577;17949;3940;740;36386;32256;229848;304;63;;list(c(673534.454017067, 678868.355284818, 726822.712026907, 725247.388900588, 672325.284698499, 673534.454017067, 6544557.89848526, 6548833.12444626, 6541863.62426728, 6525242.27716411, 6530257.07934645, 6544557.89848526))
230;021;CHATEAU THIERRY;AISNE;51666;2534;1461;12843;16191;84695;4971;3287;702;1748;23170;118573;204;02;;list(c(704806.819192542, 748025.100722044, 748514.493754812, 746710.229413543, 742051.611475847, 737208.235278887, 711525.078166727, 703944.710662149, 704806.819192542, 6899459.50822128, 6904496.18893312, 6903424.82228767, 6855140.56414095, 6854474.56276846, 6855063.59530044, 6874656.62527166, 6898599.89978044, 6899459.50822128))
231;341;BEZIERS;HERAULT;32392;618;977;7228;18744;59959;1728;52957;10167;27019;26752;178582;960;34;;list(c(696380.248600757, 705288.700929883, 742451.755455239, 751335.394092751, 741926.392831358, 731573.930638208, 719520.166757501, 718454.620385851, 696380.248600757, 6249496.01385552, 6272929.42917662, 6268754.02841931, 6253202.18940438, 6242142.4021037, 6242902.4197083, 6234870.38880397, 6233271.46974921, 6249496.01385552))
232;083;ROCROI;ARDENNES;14169;1509;568;5261;5936;27443;12446;0;818;4218;38651;83576;334;08;;"list(list(c(801046.428929291, 792483.482386558, 786954.579544643, 788564.62802215, 803862.724715952, 820886.391767126, 821908.475263941, 832448.811508442, 830493.631290593, 831416.684060439, 801046.428929291, 6960236.0410548, 6962396.74237527, 6985598.01723828, 6985043.02142229, 6983011.32620137, 6991103.92658232, 7001007.8085162, 7001803.89400041, 6989853.50025847, 6984635.12670548, 6960236.0410548)), list(c(782871.016206493, 788202.797331195, 785226.841478799, 782871.016206493, 7002734.1250951, 
6997925.47338919, 6992848.23068986, 7002734.1250951)), list(c(779959.577699603, 784045.946437083, 785962.407399999, 781684.347057009, 779959.577699603, 7014951.57347076, 7021427.81840896, 7020228.89078267, 7007713.81779289, 7014951.57347076)))"
233;674;WISSEMBOURG;BAS RHIN;18961;8287;2936;4162;409;34755;10623;937;1081;1070;31953;80419;0;67;;list(c(1046321.66125127, 1029564.89737544, 1030596.12836061, 1038633.41891881, 1055711.8254434, 1060211.57657426, 1080815.71940174, 1072972.701516, 1069167.13737954, 1046321.66125127, 6868291.19080425, 6889955.89237119, 6901238.91327437, 6893740.71877464, 6892432.50812594, 6895486.01204397, 6885889.9860804, 6867276.97739317, 6863049.48501049, 6868291.19080425))
234;597;VALENCIENNES;NORD;24265;10077;4007;5089;1653;45091;6373;0;190;512;10812;62978;671;59;;list(c(779959.577699603, 757133.632594229, 721904.07282212, 722827.519256335, 726793.988569497, 736896.12323634, 747220.326345354, 746827.300673052, 764779.130949899, 773846.602830465, 784045.946437083, 779959.577699603, 7014951.57347076, 7003267.00907824, 7030511.98465746, 7046313.81505724, 7043811.12460457, 7047421.57448372, 7039731.21542414, 7030530.77526894, 7025995.7828434, 7027808.47267567, 7021427.81840896, 7014951.57347076))
235;482;MARVEJOLS;LOZERE;52721;1717;352;811;28044;83645;28000;146;2145;31843;24656;170435;10;48;;list(c(699758.485228613, 735455.187077141, 728209.49183192, 722850.824961087, 703914.069575587, 699758.485228613, 6405347.13983458, 6417049.7796463, 6362438.35114596, 6356859.05503639, 6361872.92449235, 6405347.13983458))
236;894;SENS;YONNE;42853;2300;1139;16807;19234;82333;4224;4837;212;2160;28442;122208;27;89;;list(c(703386.542463301, 720960.689556409, 750708.200075184, 752386.12629684, 705456.090556873, 694290.900129488, 703386.542463301, 6808060.40983033, 6808743.16423698, 6796454.71502944, 6787984.31643666, 6769907.15754324, 6791556.31710441, 6808060.40983033))
237;592;CAMBRAI;NORD;44628;6901;11988;11367;1200;76084;3714;0;0;218;9244;89260;258;59;;list(c(700226.322764477, 714531.991750178, 740063.043425578, 711910.0956953, 695784.022781452, 700226.322764477, 7014458.51362662, 7020756.97750385, 6991856.07191728, 6989656.24556411, 7002936.5526476, 7014458.51362662))
238;591;AVESNES;NORD;35290;5352;2658;13341;8017;64658;37000;0;286;233;37546;139723;172;59;;list(c(721904.07282212, 757133.632594229, 743591.171203241, 740063.043425578, 714531.991750178, 721904.07282212, 7030511.98465746, 7003267.00907824, 6991337.88918668, 6991856.07191728, 7020756.97750385, 7030511.98465746))
239;635;THIERS;PUY DE DOME;21275;3491;1266;1985;20631;48648;8861;2169;856;10517;15147;86198;510;63;;list(c(725247.388900588, 726822.712026907, 736452.127158133, 757559.009266363, 769641.955394619, 765989.059455935, 738686.622409032, 728537.106289405, 725247.388900588, 6525242.27716411, 6541863.62426728, 6552502.52125097, 6550206.77050996, 6525363.14012984, 6520070.15829499, 6506524.18791251, 6512955.73086071, 6525242.27716411))
240;031;GANNAT;ALLIER;41006;3432;1264;9672;13058;68432;4509;5249;247;1680;21969;102086;22;03;;list(c(678868.355284818, 701549.0307358, 721136.040842439, 736452.127158133, 726822.712026907, 678868.355284818, 6548833.12444626, 6585076.74230379, 6580578.42600297, 6552502.52125097, 6541863.62426728, 6548833.12444626))
241;431;BRIOUDE;HAUTE LOIRE;39557;5917;897;1744;28330;76445;18177;4361;60;18041;40008;157092;10;43;;list(c(702536.672668285, 739237.369806996, 758925.82441489, 757155.849733722, 738228.36472037, 708012.674493614, 702536.672668285, 6471252.33847335, 6486079.15114682, 6466186.99219218, 6460975.04976141, 6434972.192408, 6459351.44032491, 6471252.33847335))
242;024;SOISSONS;AISNE;45985;8828;6617;14858;9236;85524;4554;2576;639;2876;27966;124135;1007;02;;list(c(708329.781068564, 718198.860213128, 750550.564337617, 748025.100722044, 704806.819192542, 708329.781068564, 6945040.90176444, 6945684.71678529, 6914676.08468672, 6904496.18893312, 6899459.50822128, 6945040.90176444))
243;025;VERVINS;AISNE;49632;5081;6852;12649;9297;83511;19222;0;3386;537;32970;139626;0;02;;list(c(743591.171203241, 757133.632594229, 779959.577699603, 781684.347057009, 780662.879912001, 782871.016206493, 785226.841478799, 781981.930445303, 786954.579544643, 792483.482386558, 772705.578494111, 743141.532040944, 743591.171203241, 6991337.88918668, 7003267.00907824, 7014951.57347076, 7007713.81779289, 7004725.60938732, 7002734.1250951, 6992848.23068986, 6987312.12677168, 6985598.01723828, 6962396.74237527, 6943590.12250765, 6965458.93947151, 6991337.88918668))
244;891;AUXERRE;YONNE;63562;4339;1720;21829;35096;126546;9071;16199;597;5431;44888;202732;279;89;;list(c(709245.920575587, 754837.232528493, 761349.872566482, 752741.656095731, 714485.584707328, 710147.494791692, 709245.920575587, 6740577.90694345, 6765557.07735054, 6730276.43305839, 6723876.80321874, 6728491.31862332, 6733402.56218073, 6740577.90694345))
245;582;CLAMECY;NIEVRE;42610;1455;1998;6849;17544;70456;17049;3212;121;2720;53307;146865;33;58;;list(c(714485.584707328, 752741.656095731, 756154.151912519, 738806.693321397, 719799.350213018, 714485.584707328, 6728491.31862332, 6723876.80321874, 6686005.1567784, 6673520.61932951, 6683233.13891515, 6728491.31862332))
246;104;NOGENT SUR SEINE;AUBE;44461;1278;1177;8214;15983;71113;6846;992;29;949;9828;89757;96;10;;list(c(720960.689556409, 742051.611475847, 746710.229413543, 758354.358740199, 760967.238551849, 750708.200075184, 720960.689556409, 6808743.16423698, 6854474.56276846, 6855140.56414095, 6849104.31827202, 6816280.90886276, 6796454.71502944, 6808743.16423698))
247;304;LE VIGAN;GARD;10029;1644;180;2220;8443;22516;2463;4953;24331;43982;41970;140215;0;30;;list(c(733796.42849086, 764195.598534899, 778139.364161717, 749608.080533733, 726908.544592508, 733796.42849086, 6338886.45383558, 6339571.19326741, 6308334.89605412, 6294641.96346368, 6316408.7610247, 6338886.45383558))
248;481;FLORAC;LOZERE;22749;1067;236;655;9052;33759;13582;871;26800;69976;23848;168836;0;48;;list(c(728209.49183192, 771084.052932207, 778759.174352363, 764195.598534899, 733796.42849086, 722850.824961087, 728209.49183192, 6362438.35114596, 6382135.06987957, 6365255.54215706, 6339571.19326741, 6338886.45383558, 6356859.05503639, 6362438.35114596))
249;483;MENDE;LOZERE;51494;1379;246;662;20898;74679;13976;18;3130;60072;25828;177703;642;48;;list(c(738415.54712523, 771011.041655448, 771084.052932207, 728209.49183192, 735455.187077141, 738415.54712523, 6418861.74927397, 6400123.57464992, 6382135.06987957, 6362438.35114596, 6417049.7796463, 6418861.74927397))
250;513;REIMS;MARNE;65603;4482;1490;21448;30814;123837;6000;7263;844;2181;30292;170417;856;51;;list(c(748025.100722044, 750550.564337617, 771783.754747394, 802998.459119925, 806046.906056692, 784785.494638672, 748514.493754812, 748025.100722044, 6904496.18893312, 6914676.08468672, 6934374.11698123, 6909708.79368888, 6902265.0985813, 6889862.98751571, 6903424.82228767, 6904496.18893312))
251;022;LAON;AISNE;91883;13024;11237;22377;29248;167769;20187;3170;2006;4925;47532;245589;1127;02;;list(c(743141.532040944, 772705.578494111, 771783.754747394, 750550.564337617, 718198.860213128, 743141.532040944, 6965458.93947151, 6943590.12250765, 6934374.11698123, 6914676.08468672, 6945684.71678529, 6965458.93947151))
252;581;CHATEAU CHINON;NIEVRE;36420;4191;1368;2893;36945;81817;28000;254;471;871;56158;167571;976;58;;list(c(756154.151912519, 780919.969522827, 794885.382583711, 768940.968442869, 764515.322331833, 744644.233176312, 738806.693321397, 756154.151912519, 6686005.1567784, 6686554.76511733, 6677750.58410055, 6623202.59303471, 6621413.26596518, 6637317.51409713, 6673520.61932951, 6686005.1567784))
253;034;LA PALISSE;ALLIER;64370;6342;1289;7163;26408;105572;16755;4081;147;5150;30286;161991;124;03;;list(c(721136.040842439, 762375.444599244, 775086.833178618, 757559.009266363, 736452.127158133, 721136.040842439, 6580578.42600297, 6607611.46819427, 6577530.26994491, 6550206.77050996, 6552502.52125097, 6580578.42600297))
254;895;TONNERRE;YONNE;47563;2998;816;9375;18832;79584;2560;5962;363;2543;30221;121233;100;89;;list(c(759670.230313349, 777865.886829375, 795252.32181508, 796729.191467931, 785566.189491761, 761349.872566482, 754837.232528493, 759670.230313349, 6776737.05406416, 6774307.57416001, 6757706.23649452, 6734233.04677698, 6727958.16052616, 6730276.43305839, 6765557.07735054, 6776737.05406416))
255;105;TROYES;AUBE;65599;3478;2542;11843;17571;101033;12060;4280;772;1685;37114;156944;158;10;;list(c(750708.200075184, 760967.238551849, 805094.770315522, 804720.287447886, 777865.886829375, 759670.230313349, 752386.12629684, 750708.200075184, 6796454.71502944, 6816280.90886276, 6808896.51597759, 6805799.32528177, 6774307.57416001, 6776737.05406416, 6787984.31643666, 6796454.71502944))
256;631;AMBERT;PUY DE DOME;30917;2382;630;540;18724;53193;16773;0;0;22612;25932;118510;0;63;;list(c(765989.059455935, 776676.469957499, 758925.82441489, 739237.369806996, 738686.622409032, 765989.059455935, 6520070.15829499, 6475030.12640181, 6466186.99219218, 6486079.15114682, 6506524.18791251, 6520070.15829499))
257;433;LE PUY;HAUTE LOIRE;66481;10750;500;1591;23769;103091;49756;895;200;25872;43823;223637;164;43;;list(c(738228.36472037, 757155.849733722, 799102.446779669, 794830.419719339, 771011.041655448, 738415.54712523, 738228.36472037, 6434972.192408, 6460975.04976141, 6421397.0094643, 6414242.38539736, 6400123.57464992, 6418861.74927397, 6434972.192408))
258;892;AVALLON;YONNE;33763;1738;989;4532;16378;57400;7329;3372;308;2140;29387;99936;0;89;;list(c(761349.872566482, 785566.189491761, 780919.969522827, 756154.151912519, 752741.656095731, 761349.872566482, 6730276.43305839, 6727958.16052616, 6686554.76511733, 6686005.1567784, 6723876.80321874, 6730276.43305839))
259;512;EPERNAY;MARNE;87470;4162;2120;20428;33629;147809;11300;6210;792;4691;44292;215094;146;51;;list(c(748514.493754812, 784785.494638672, 774556.989226965, 758354.358740199, 746710.229413543, 748514.493754812, 6903424.82228767, 6889862.98751571, 6853772.3370334, 6849104.31827202, 6855140.56414095, 6903424.82228767))
260;422;ROANNE;LOIRE;52649;4727;1423;3318;39808;101925;26906;6733;23;8533;34342;178462;32;42;;list(c(757559.009266363, 775086.833178618, 810794.228370806, 806029.307259563, 769641.955394619, 757559.009266363, 6550206.77050996, 6577530.26994491, 6566301.19101783, 6525410.67153418, 6525363.14012984, 6550206.77050996))
261;432;ISSINGEAUX;HAUTE LOIRE;30251;4477;512;106;13657;49003;23518;373;4;13832;28766;115496;14;43;;list(c(758925.82441489, 776676.469957499, 781710.568962222, 813169.468701536, 810868.50941258, 799102.446779669, 757155.849733722, 758925.82441489, 6466186.99219218, 6475030.12640181, 6474870.70677837, 6450770.9231354, 6432968.67755678, 6421397.0094643, 6460975.04976141, 6466186.99219218))
262;071;L'ARGENTIERE;ARDECHE;15763;3549;345;308;11068;31033;16560;13923;29675;60715;40809;192715;300;07;;list(c(771011.041655448, 794830.419719339, 820626.642981136, 823167.630714123, 819882.311264738, 809323.147082312, 778759.174352363, 771084.052932207, 771011.041655448, 6400123.57464992, 6414242.38539736, 6386634.17562471, 6359562.04332217, 6356499.74919489, 6354534.77162456, 6365255.54215706, 6382135.06987957, 6400123.57464992))
263;301;ALES;GARD;8543;1405;356;2169;6540;19013;3208;10495;32215;16786;49416;131133;0;30;;list(c(764195.598534899, 778759.174352363, 809323.147082312, 795573.647714243, 778335.069012103, 778139.364161717, 764195.598534899, 6339571.19326741, 6365255.54215706, 6354534.77162456, 6319380.80657902, 6308278.07946608, 6308334.89605412, 6339571.19326741))
264;713;CHAROLLES;SAONE ET LOIRE;80609;10293;3754;4753;42165;141574;41767;3748;262;5799;56469;249619;1030;71;;list(c(764515.322331833, 768940.968442869, 812837.067625074, 824677.5508902, 811508.037408181, 810794.228370806, 775086.833178618, 762375.444599244, 764515.322331833, 6621413.26596518, 6623202.59303471, 6622049.96982512, 6608693.19044495, 6566801.03718671, 6566301.19101783, 6577530.26994491, 6607611.46819427, 6621413.26596518))
265;214;SEMUR;COTE D'OR;67004;3853;2972;6966;18100;98895;16683;3602;962;4593;38334;163069;120;21;;list(c(780919.969522827, 785566.189491761, 796729.191467931, 829411.301389578, 822566.010928704, 813387.328354553, 794885.382583711, 780919.969522827, 6686554.76511733, 6727958.16052616, 6734233.04677698, 6719342.71119994, 6686840.98225753, 6678351.42924815, 6677750.58410055, 6686554.76511733))
266;421;MONTBRISON;LOIRE;66712;7081;2316;3282;28003;107394;32522;3346;93;15518;35182;194055;10;42;;list(c(769641.955394619, 806029.307259563, 809014.381578516, 809638.143078759, 812498.093041807, 781710.568962222, 776676.469957499, 765989.059455935, 769641.955394619, 6525363.14012984, 6525410.67153418, 6521962.05320844, 6521093.55834493, 6511939.89555103, 6474870.70677837, 6475030.12640181, 6520070.15829499, 6525363.14012984))
267;082;RETHEL;ARDENNES;49486;1768;6632;19110;18868;95864;7035;640;2208;743;15818;122308;136;08;;list(c(771783.754747394, 772705.578494111, 792483.482386558, 801046.428929291, 818428.631405788, 802998.459119925, 771783.754747394, 6934374.11698123, 6943590.12250765, 6962396.74237527, 6960236.0410548, 6945982.11224556, 6909708.79368888, 6934374.11698123))
268;101;ARCIS SUR AUBE;AUBE;72593;2733;1041;10602;22234;109203;6867;520;2080;55;7116;125841;43;10;;list(c(758354.358740199, 774556.989226965, 792116.89857912, 813043.797246986, 805094.770315522, 760967.238551849, 758354.358740199, 6849104.31827202, 6853772.3370334, 6849767.08927163, 6819656.40559419, 6808896.51597759, 6816280.90886276, 6849104.31827202))
269;103;BAR SUR SEINE;AUBE;42896;1885;1087;7247;14509;67624;4796;12083;201;7267;31173;123144;0;10;;list(c(804720.287447886, 822721.021777851, 795252.32181508, 777865.886829375, 804720.287447886, 6805799.32528177, 6773071.27658374, 6757706.23649452, 6774307.57416001, 6805799.32528177))
270;423;SAINT ETIENNE;LOIRE;22999;4641;1142;3257;9472;41511;24236;2594;446;7816;26842;103445;100;42;;list(c(781710.568962222, 812498.093041807, 822310.755399199, 832479.47799492, 813169.468701536, 781710.568962222, 6474870.70677837, 6511939.89555103, 6502655.75251572, 6467984.97252118, 6450770.9231354, 6474870.70677837))
271;511;CHALONS SUR MARNE;MARNE;78962;3314;1610;15508;48956;148350;4906;700;176;588;10623;165343;48;51;;list(c(784785.494638672, 806046.906056692, 813307.626598802, 820745.389079078, 792116.89857912, 774556.989226965, 784785.494638672, 6889862.98751571, 6902265.0985813, 6898201.05770096, 6874033.99879748, 6849767.08927163, 6853772.3370334, 6889862.98751571))
272;302;NIMES;GARD;31076;1192;1055;8065;8398;49786;2323;44686;4816;36614;25428;163653;2400;30;;list(c(795573.647714243, 827493.122699706, 831950.847866546, 801769.943583355, 778335.069012103, 795573.647714243, 6319380.80657902, 6311403.05906149, 6297920.05364156, 6273502.61398826, 6308278.07946608, 6319380.80657902))
273;212;CHATILLON SUR SEINE;COTE D'OR;65261;6858;1631;12045;19335;105130;5747;4191;303;3349;78752;197472;491;21;;list(c(795252.32181508, 822721.021777851, 836725.480116008, 846432.637951853, 847070.955547444, 829411.301389578, 796729.191467931, 795252.32181508, 6757706.23649452, 6773071.27658374, 6769997.01465889, 6755014.97750912, 6730085.79977421, 6719342.71119994, 6734233.04677698, 6757706.23649452))
274;515;VITRY LE FRANCOIS;MARNE;62704;2730;2897;11765;37312;117408;11601;2864;336;1310;20314;153833;400;51;;list(c(792116.89857912, 820745.389079078, 837049.636208872, 839106.907697689, 813984.28003402, 813043.797246986, 792116.89857912, 6849767.08927163, 6874033.99879748, 6864236.90944319, 6845855.66742259, 6819830.32935303, 6819656.40559419, 6849767.08927163))
275;102;BAR SUR AUBE;AUBE;32750;1107;2019;7098;11971;54945;8460;5037;143;2981;32887;104453;0;10;;list(c(805094.770315522, 813043.797246986, 813984.28003402, 850319.14639374, 836725.480116008, 822721.021777851, 804720.287447886, 805094.770315522, 6808896.51597759, 6819656.40559419, 6819830.32935303, 6801300.58284926, 6769997.01465889, 6773071.27658374, 6805799.32528177, 6808896.51597759))
276;692;VILLEFRANCHE;RHONE;40944;2549;2771;4521;25921;76706;19144;17000;1209;11264;24476;149799;34;69;;list(c(806029.307259563, 810794.228370806, 811508.037408181, 850616.278322094, 854098.383149228, 809014.381578516, 806029.307259563, 6525410.67153418, 6566301.19101783, 6566801.03718671, 6561172.44690843, 6555724.59066959, 6521962.05320844, 6525410.67153418))
277;711;AUTUN;SAONE ET LOIRE;65496;7212;1862;3863;41096;119529;23426;3951;550;2330;41121;190907;78;71;;list(c(794885.382583711, 813387.328354553, 821830.159803406, 812837.067625074, 768940.968442869, 794885.382583711, 6677750.58410055, 6678351.42924815, 6646087.76976881, 6622049.96982512, 6623202.59303471, 6677750.58410055))
278;072;PRIVAS;ARDECHE;25054;5233;505;2318;15307;48417;8480;9620;15874;47720;44262;174373;0;07;;list(c(799102.446779669, 810868.50941258, 830465.392899644, 848078.690136016, 820626.642981136, 794830.419719339, 799102.446779669, 6421397.0094643, 6432968.67755678, 6424220.31846458, 6405141.43922952, 6386634.17562471, 6414242.38539736, 6421397.0094643))
279;715;MACON;SAONE ET LOIRE;32914;5789;3116;3146;5546;50511;18400;15855;170;6005;28753;119694;15;71;;list(c(824677.5508902, 846706.7571158, 862648.396318184, 850616.278322094, 811508.037408181, 824677.5508902, 6608693.19044495, 6607807.15719093, 6593058.37957156, 6561172.44690843, 6566801.03718671, 6608693.19044495))
280;085;VOUZIERS;ARDENNES;56059;2743;1281;12592;18625;91300;12362;869;1950;1837;30773;139091;383;08;;list(c(802998.459119925, 818428.631405788, 822414.197617435, 847123.178643723, 851497.62441797, 851127.33878411, 813307.626598802, 806046.906056692, 802998.459119925, 6909708.79368888, 6945982.11224556, 6945903.10356418, 6934001.15887602, 6916700.84048369, 6916092.0271658, 6898201.05770096, 6902265.0985813, 6909708.79368888))
281;303;UZES;GARD;28491;3476;974;6631;12198;51770;1037;17660;7479;23885;46724;148555;36;30;;list(c(819882.311264738, 831332.927378951, 827493.122699706, 795573.647714243, 809323.147082312, 819882.311264738, 6356499.74919489, 6325753.82170252, 6311403.05906149, 6319380.80657902, 6354534.77162456, 6356499.74919489))
282;842;AVIGNON;VAUCLUSE;12475;1490;5731;2830;3958;26484;1288;5145;875;7504;8436;49732;0;84;;list(c(831332.927378951, 852690.748629848, 868508.101393901, 866404.314544369, 863131.597650592, 831950.847866546, 827493.122699706, 831332.927378951, 6325753.82170252, 6328771.89863979, 6308639.03871113, 6291738.08090563, 6288315.3157262, 6297920.05364156, 6311403.05906149, 6325753.82170252))
283;553;MONTMEDY;MEUSE;58039;3261;2003;6764;13066;83133;14347;1695;637;1425;33841;135078;0;55;;list(c(901832.567296144, 888192.239805975, 851497.62441797, 847123.178643723, 861219.611367917, 863589.130859147, 873087.725396365, 879011.495645027, 892918.701616995, 902061.663081323, 901832.567296144, 6938490.2528066, 6917400.23986716, 6916700.84048369, 6934001.15887602, 6957428.56609383, 6957599.69033637, 6949028.89602606, 6935907.82110863, 6942454.30730874, 6939414.20182702, 6938490.2528066))
284;574;THIONVILLE;MOSELLE;37624;5863;2374;8514;8227;62602;7430;1107;1345;931;32687;106102;3;57;;list(c(902061.663081323, 909646.188974101, 915612.069967858, 934755.005022987, 957883.984145559, 959257.78720092, 964337.087616747, 964327.882375713, 928668.427776873, 901832.567296144, 902061.663081323, 6939414.20182702, 6936892.28823995, 6933626.10419771, 6939684.65069285, 6930306.21138419, 6922051.29509521, 6914585.64328138, 6914561.71268528, 6908559.860104, 6938490.2528066, 6939414.20182702))
285;084;SEDAN;ARDENNES;25873;1695;1052;7644;6812;43076;8836;95;254;1384;26186;79831;187;08;;list(c(847123.178643723, 822414.197617435, 837594.388009895, 856231.176887881, 861219.611367917, 847123.178643723, 6934001.15887602, 6945903.10356418, 6971067.95589714, 6957068.30652433, 6957428.56609383, 6934001.15887602))
286;211;BEAUNE;COTE D'OR;67103;5784;4757;8425;19169;105238;23951;14138;378;9277;61272;214254;11;21;;list(c(822566.010928704, 863960.60642861, 866868.303551055, 821830.159803406, 813387.328354553, 822566.010928704, 6686840.98225753, 6670419.60312376, 6648285.62219818, 6646087.76976881, 6678351.42924815, 6686840.98225753))
287;844;ORANGE;VAUCLUSE;22074;2580;2993;3348;13241;44236;1462;9931;743;17097;24263;97732;27;84;;list(c(823167.630714123, 845206.827944895, 859128.500487384, 852690.748629848, 831332.927378951, 819882.311264738, 823167.630714123, 6359562.04332217, 6362194.86436077, 6349017.43013991, 6328771.89863979, 6325753.82170252, 6356499.74919489, 6359562.04332217))
288;015;TREVOUX;AIN;52063;4954;4425;4985;11707;78134;14924;4213;37;4579;46450;148337;30;01;;list(c(809014.381578516, 854098.383149228, 869500.422297017, 809638.143078759, 809014.381578516, 6521962.05320844, 6555724.59066959, 6537301.81955494, 6521093.55834493, 6521962.05320844))
289;073;TOURNON;ARDECHE;33674;9967;972;2540;11882;59035;18018;6102;18753;36556;47113;185577;601;07;;list(c(813169.468701536, 832479.47799492, 856560.207241578, 863564.604148867, 830465.392899644, 810868.50941258, 813169.468701536, 6450770.9231354, 6467984.97252118, 6466206.20985892, 6443465.42661454, 6424220.31846458, 6432968.67755678, 6450770.9231354))
290;514;SAINTE MENEHOULD;MARNE;55355;1618;919;8364;17620;83876;4892;342;1487;1328;21432;113357;141;51;;list(c(851127.33878411, 860691.888624298, 837049.636208872, 820745.389079078, 813307.626598802, 851127.33878411, 6916092.0271658, 6876542.88649691, 6864236.90944319, 6874033.99879748, 6898201.05770096, 6916092.0271658))
291;081;MEZIERES;ARDENNES;26252;2259;966;5808;7499;42784;10569;0;646;1752;42732;98483;299;08;;list(c(801046.428929291, 831416.684060439, 833237.616873306, 837594.388009895, 822414.197617435, 818428.631405788, 801046.428929291, 6960236.0410548, 6984635.12670548, 6974340.69073946, 6971067.95589714, 6945903.10356418, 6945982.11224556, 6960236.0410548))
292;213;DIJON;COTE D'OR;104232;9144;7510;17004;21237;159127;17246;7880;721;5701;110646;301321;220;21;;list(c(829411.301389578, 847070.955547444, 869182.64258755, 878399.712151933, 863960.60642861, 822566.010928704, 829411.301389578, 6719342.71119994, 6730085.79977421, 6722162.65595081, 6689447.27322271, 6670419.60312376, 6686840.98225753, 6719342.71119994))
293;691;LYON;RHONE;46912;9395;3781;6413;3794;70295;17513;14896;2923;3865;19748;129240;45;69;;list(c(809638.143078759, 869500.422297017, 875930.393843779, 875931.837828872, 866674.107748348, 822310.755399199, 812498.093041807, 809638.143078759, 6521093.55834493, 6537301.81955494, 6533382.36062479, 6532991.24961718, 6509684.56866902, 6502655.75251572, 6511939.89555103, 6521093.55834493))
294;262;MONTELIMAR;DROME;29043;4458;1159;5514;6930;47104;2028;9925;309;13388;40481;113235;300;26;;list(c(820626.642981136, 848078.690136016, 862031.920990646, 865932.7259329, 845206.827944895, 823167.630714123, 820626.642981136, 6386634.17562471, 6405141.43922952, 6400887.72981826, 6392425.71550912, 6362194.86436077, 6359562.04332217, 6386634.17562471))
295;132;AIX;BOUCHES DU RHONE;31335;3664;2371;3362;11229;51961;1985;24879;23921;70776;41770;215292;1262;13;;list(c(863131.597650592, 866404.314544369, 914270.601748433, 926291.652744684, 919442.296402507, 874517.736530763, 870558.783212125, 863336.257723348, 863131.597650592, 6288315.3157262, 6291738.08090563, 6293838.1836348, 6286221.87058665, 6259721.63941388, 6259300.06733924, 6271870.60212032, 6266837.87415571, 6288315.3157262))
296;133;MARSEILLE;BOUCHES DU RHONE;7384;2421;711;526;1621;12663;759;10986;1366;15125;24906;65805;0;13;;list(c(919442.296402507, 920984.46861048, 915102.784253485, 892715.179869713, 891920.767471911, 865554.132003375, 874627.628906041, 874517.736530763, 919442.296402507, 6259721.63941388, 6253507.87612492, 6235034.83298475, 6237167.51047712, 6248753.32450231, 6249818.10181834, 6258951.13523158, 6259300.06733924, 6259721.63941388))
297;712;CHALON /SAONE;SAONE ET LOIRE;47020;7586;4561;4893;21770;85830;20377;11700;41;5450;48681;172079;107;71;;list(c(821830.159803406, 866868.303551055, 867861.888926303, 846706.7571158, 824677.5508902, 812837.067625074, 821830.159803406, 6646087.76976881, 6648285.62219818, 6646816.87600698, 6607807.15719093, 6608693.19044495, 6622049.96982512, 6646087.76976881))
298;012;BOURG;AIN;58528;7410;3706;5076;1668;76388;30692;4495;173;9319;44791;165858;24;01;;list(c(850616.278322094, 862648.396318184, 889281.663856613, 891374.78650769, 891883.675031746, 881876.277735824, 875930.393843779, 869500.422297017, 854098.383149228, 850616.278322094, 6561172.44690843, 6593058.37957156, 6594007.87814481, 6593133.93830608, 6592140.38971313, 6537679.79476278, 6533382.36062479, 6537301.81955494, 6555724.59066959, 6561172.44690843))
299;554;VERDUN;MEUSE;53082;4145;2671;7055;16046;82999;13038;2208;1242;1353;48158;148998;23;55;;list(c(851127.33878411, 851497.62441797, 888192.239805975, 900226.893837767, 874613.763541275, 860691.888624298, 851127.33878411, 6916092.0271658, 6916700.84048369, 6917400.23986716, 6882119.69070583, 6872466.08417464, 6876542.88649691, 6916092.0271658))
300;521;CHAUMONT;HAUTE MARNE;86248;3640;3653;8072;30337;131950;12900;4692;459;5675;89181;244857;104;52;;list(c(836725.480116008, 850319.14639374, 868924.617154661, 891522.350073503, 846432.637951853, 836725.480116008, 6769997.01465889, 6801300.58284926, 6808659.59874355, 6779642.85700731, 6755014.97750912, 6769997.01465889))
301;523;WASSY;HAUTE MARNE;51411;1893;1876;6843;19603;81626;9559;4918;778;3545;56398;156824;88;52;;list(c(839106.907697689, 873439.986001893, 868924.617154661, 850319.14639374, 813984.28003402, 839106.907697689, 6845855.66742259, 6826220.71854054, 6808659.59874355, 6801300.58284926, 6819830.32935303, 6845855.66742259))
302;551;BAR LE DUC;MEUSE;55565;4219;2172;8591;16489;87036;6749;6011;1015;1600;39501;141912;18;55;;list(c(860691.888624298, 874613.763541275, 873547.381102584, 873439.986001893, 839106.907697689, 837049.636208872, 860691.888624298, 6876542.88649691, 6872466.08417464, 6826317.24585101, 6826220.71854054, 6845855.66742259, 6864236.90944319, 6876542.88649691))
303;384;VIENNE;ISERE;66758;6998;2370;14868;16895;107889;10354;5836;1208;4475;47710;177472;3100;38;;list(c(866674.107748348, 871508.348971531, 856560.207241578, 832479.47799492, 822310.755399199, 866674.107748348, 6509684.56866902, 6479342.79435995, 6466206.20985892, 6467984.97252118, 6502655.75251572, 6509684.56866902))
304;714;LOUHANS;SAONE ET LOIRE;46625;2644;5115;1224;13483;69091;21002;374;212;394;31802;122875;605;71;;list(c(867861.888926303, 878398.822207402, 889281.663856613, 862648.396318184, 846706.7571158, 867861.888926303, 6646816.87600698, 6642905.03731707, 6594007.87814481, 6593058.37957156, 6607807.15719093, 6646816.87600698))
305;264;VALENCE;DROME;64156;9787;3399;15800;13515;106657;7917;6209;1402;12089;53670;187944;1000;26;;list(c(830465.392899644, 863564.604148867, 875635.908093982, 862031.920990646, 848078.690136016, 830465.392899644, 6424220.31846458, 6443465.42661454, 6429314.52765168, 6400887.72981826, 6405141.43922952, 6424220.31846458))
306;391;DOLE;JURA;33592;2291;3508;3397;9482;52270;10164;4550;138;2146;48665;117933;130;39;;list(c(866868.303551055, 863960.60642861, 878399.712151933, 904787.498811143, 916388.959457393, 883148.528779088, 878398.822207402, 867861.888926303, 866868.303551055, 6648285.62219818, 6670419.60312376, 6689447.27322271, 6684655.78013249, 6664706.86157508, 6643509.08813668, 6642905.03731707, 6646816.87600698, 6648285.62219818))
307;263;NYONS;DROME;21464;3531;766;4803;8904;39468;1324;3623;1046;35656;34917;116034;0;26;;list(c(845206.827944895, 865932.7259329, 905963.486506509, 899194.699026366, 898692.73083572, 894652.099673542, 859128.500487384, 845206.827944895, 6362194.86436077, 6392425.71550912, 6374622.68845117, 6346620.25053777, 6345985.49689363, 6344282.42459585, 6349017.43013991, 6362194.86436077))
308;841;APT;VAUCLUSE;20018;4430;931;3729;15884;44992;1218;9055;1317;25112;40676;122370;0;84;;list(c(868508.101393901, 894652.099673542, 898692.73083572, 914270.601748433, 866404.314544369, 868508.101393901, 6308639.03871113, 6344282.42459585, 6345985.49689363, 6293838.1836348, 6291738.08090563, 6308639.03871113))
309;382;SAINT-MARCELLIN;ISERE;27966;3664;1718;6073;6631;46052;9327;7485;1313;3169;39811;107157;159;38;;list(c(856560.207241578, 871508.348971531, 894776.870626451, 900810.450100265, 875635.908093982, 863564.604148867, 856560.207241578, 6466206.20985892, 6479342.79435995, 6475043.32308624, 6433252.6779963, 6429314.52765168, 6443465.42661454, 6466206.20985892))
310;843;CARPENTRAS;VAUCLUSE;21425;6065;392;2699;14687;45268;1715;4839;690;19007;13418;84937;17;84;;list(c(859128.500487384, 894652.099673542, 868508.101393901, 852690.748629848, 859128.500487384, 6349017.43013991, 6344282.42459585, 6308639.03871113, 6328771.89863979, 6349017.43013991))
311;522;LANGRES;HAUTE MARNE;81147;3591;2937;10030;31356;129061;16600;6776;454;7483;59912;220286;751;52;;list(c(846432.637951853, 891522.350073503, 908899.266174738, 914504.865406983, 904555.378815772, 869182.64258755, 847070.955547444, 846432.637951853, 6755014.97750912, 6779642.85700731, 6772037.75328893, 6765723.65137172, 6739056.40467095, 6722162.65595081, 6730085.79977421, 6755014.97750912))
312;261;DIE;DROME;43614;4483;265;5994;20478;74834;5165;4481;204;64879;85379;234942;378;26;;list(c(862031.920990646, 875635.908093982, 900810.450100265, 923043.794940778, 908472.739328397, 905963.486506509, 865932.7259329, 862031.920990646, 6400887.72981826, 6429314.52765168, 6433252.6779963, 6422210.07653362, 6376507.88514578, 6374622.68845117, 6392425.71550912, 6400887.72981826))
313;883;NEUFCHATEAU;VOSGES;39874;3440;1159;3957;16357;64787;10457;2208;435;2688;42235;122810;26;88;;list(c(873547.381102584, 896035.677533625, 918232.163081071, 908899.266174738, 891522.350073503, 868924.617154661, 873439.986001893, 873547.381102584, 6826317.24585101, 6831824.60528453, 6823224.01147584, 6772037.75328893, 6779642.85700731, 6808659.59874355, 6826220.71854054, 6826317.24585101))
314;571;BRIEY;MOSELLE;47914;5236;1975;9810;12423;77358;7626;273;381;1006;32208;118852;23;57;;list(c(901832.567296144, 928668.427776873, 904990.180469012, 900226.893837767, 888192.239805975, 901832.567296144, 6938490.2528066, 6908559.860104, 6880047.38417663, 6882119.69070583, 6917400.23986716, 6938490.2528066))
315;383;LA TOUR DU PIN;ISERE;52214;4813;1154;5212;8623;72016;14954;2915;1967;7283;34042;133177;1715;38;;list(c(875931.837828872, 921521.959789209, 894776.870626451, 871508.348971531, 866674.107748348, 875931.837828872, 6532991.24961718, 6489168.95200593, 6475043.32308624, 6479342.79435995, 6509684.56866902, 6532991.24961718))
316;552;COMMERCY;MEUSE;64469;5796;4150;5436;23941;103792;14540;3264;603;4372;70228;196799;148;55;;list(c(904990.180469012, 908442.179822664, 896035.677533625, 873547.381102584, 874613.763541275, 900226.893837767, 904990.180469012, 6880047.38417663, 6876302.79450235, 6831824.60528453, 6826317.24585101, 6872466.08417464, 6882119.69070583, 6880047.38417663))
317;701;GRAY;HAUTE SAONE;57697;3357;2075;6432;17687;87248;13852;6521;350;4417;46677;159065;314;70;;list(c(869182.64258755, 904555.378815772, 920804.307477958, 904787.498811143, 878399.712151933, 869182.64258755, 6722162.65595081, 6739056.40467095, 6712074.3313416, 6684655.78013249, 6689447.27322271, 6722162.65595081))
318;392;LONS LE SAUNIER;JURA;43809;5529;2216;6910;5351;63815;16693;9834;256;24736;39039;154373;451;39;;list(c(878398.822207402, 883148.528779088, 919813.052186222, 891374.78650769, 889281.663856613, 878398.822207402, 6642905.03731707, 6643509.08813668, 6618662.45734855, 6593133.93830608, 6594007.87814481, 6642905.03731707))
319;545;TOUL;MEURTHE;36851;4610;1102;4636;11327;58526;7300;5532;355;1927;43172;116812;2;54;;list(c(908442.179822664, 921350.972540475, 925213.54719996, 918232.163081071, 896035.677533625, 908442.179822664, 6876302.79450235, 6870930.27309123, 6826188.67120368, 6823224.01147584, 6831824.60528453, 6876302.79450235))
320;011;BELLEY;AIN;40136;3298;1174;4610;5772;54990;15334;4483;63;14613;41455;130938;76;01;;list(c(875930.393843779, 881876.277735824, 938122.091988666, 995358.969200729, 996115.687904216, 1000033.45862987, 969431.871739863, 921521.959789209, 875931.837828872, 875930.393843779, 6533382.36062479, 6537679.79476278, 6547821.454126, 6526889.99320914, 6521090.38624492, 6518875.00348942, 6492188.82512509, 6489168.95200593, 6532991.24961718, 6533382.36062479))
321;381;GRENOBLE;ISERE;50640;6551;2969;12711;15039;87910;31886;9855;3542;95581;182354;411128;1608;38;;list(c(921521.959789209, 969431.871739863, 946846.66213321, 923043.794940778, 900810.450100265, 894776.870626451, 921521.959789209, 6489168.95200593, 6492188.82512509, 6432929.88687068, 6422210.07653362, 6433252.6779963, 6475043.32308624, 6489168.95200593))
322;044;FORCALQUIER;BASSES ALPES;16656;2595;90;1130;13278;33749;1597;4792;1635;30524;34894;107191;15;04;;list(c(899194.699026366, 941908.673845336, 950945.695642352, 948148.641528403, 926291.652744684, 914270.601748433, 898692.73083572, 899194.699026366, 6346620.25053777, 6330107.83199113, 6311288.94124545, 6295271.12408316, 6286221.87058665, 6293838.1836348, 6345985.49689363, 6346620.25053777))
323;834;TOULON;VAR;11107;908;811;1361;5455;19642;598;26841;7169;14000;60820;129070;115;83;;list(c(920984.46861048, 977118.402359926, 946348.427225304, 928602.685316149, 917349.565561561, 915102.784253485, 920984.46861048, 6253507.87612492, 6232719.12134293, 6224642.72485833, 6228119.87574369, 6234820.80115518, 6235034.83298475, 6253507.87612492))
324;394;SAINT CLAUDE;JURA;13021;2231;205;7054;5831;28342;8967;78;61;28630;37701;103779;116;39;;list(c(891374.78650769, 919813.052186222, 937287.132830407, 941571.058079956, 919800.801082142, 891883.675031746, 891374.78650769, 6593133.93830608, 6618662.45734855, 6624064.39949003, 6621400.26969575, 6573402.32788877, 6592140.38971313, 6593133.93830608))
325;014;NANTUA;AIN;19347;2262;437;2123;4439;28608;14759;1688;303;12307;35657;93322;173;01;;list(c(891883.675031746, 919800.801082142, 938122.091988666, 881876.277735824, 891883.675031746, 6592140.38971313, 6573402.32788877, 6547821.454126, 6537679.79476278, 6592140.38971313))
326;393;POLIGNY;JURA;23746;1307;1570;12310;6463;45396;12252;5147;154;8603;51764;123316;550;39;;list(c(883148.528779088, 916388.959457393, 928809.446087219, 937287.132830407, 919813.052186222, 883148.528779088, 6643509.08813668, 6664706.86157508, 6659461.48507649, 6624064.39949003, 6618662.45734855, 6643509.08813668))
327;252;BESANCON;DOUBS;32246;3340;1438;8019;4060;49103;20959;5992;1342;11445;50427;139268;679;25;;list(c(916388.959457393, 904787.498811143, 920804.307477958, 933270.240495217, 948487.549637803, 928809.446087219, 916388.959457393, 6664706.86157508, 6684655.78013249, 6712074.3313416, 6709406.10266564, 6675091.93501817, 6659461.48507649, 6664706.86157508))
328;882;MIRECOURT;VOSGES;38441;3343;1133;5470;16333;64720;11016;2313;839;1162;32433;112483;67;88;;list(c(908899.266174738, 918232.163081071, 925213.54719996, 939694.304397422, 953467.45042273, 932836.13792965, 928821.792674589, 914504.865406983, 908899.266174738, 6772037.75328893, 6823224.01147584, 6826188.67120368, 6825433.74253288, 6814550.23091819, 6771236.51732129, 6766782.38159316, 6765723.65137172, 6772037.75328893))
329;045;SISTERON;BASSES ALPES;16137;557;108;1338;9064;27204;3216;2619;72;38082;33279;104472;2;04;;list(c(905963.486506509, 908472.739328397, 955270.793133213, 941908.673845336, 899194.699026366, 905963.486506509, 6374622.68845117, 6376507.88514578, 6366558.07415452, 6330107.83199113, 6346620.25053777, 6374622.68845117))
330;703;VESOUL;HAUTE SAONE;67884;4345;2949;8137;17998;101313;18278;5208;742;9715;54753;190009;418;70;;list(c(914504.865406983, 928821.792674589, 943330.997683791, 953052.055496909, 933270.240495217, 920804.307477958, 904555.378815772, 914504.865406983, 6765723.65137172, 6766782.38159316, 6756973.63274456, 6719420.65729984, 6709406.10266564, 6712074.3313416, 6739056.40467095, 6765723.65137172))
331;013;GEX;AIN;6611;1069;546;2596;780;11602;8188;585;5;7064;13998;41442;114;01;;"list(c(919800.801082142, 941571.058079956, 946232.054077495, 940331.290261556, 935267.691137149, 943632.474950512, 929260.628069444, 928162.403921598, 938562.704111603, 953864.919869839, 951982.685517406, 960334.188638303, 972289.312999415, 988569.188485271, 997441.883331618, 993105.721144885, 1000892.33273083, 1011380.28944664, 1009908.69261635, 996609.989283022, 995345.023407895, 995358.969200729, 938122.091988666, 919800.801082142, 6573402.32788877, 6621400.26969575, 6619738.26034116, 6611195.31274004, 
6595279.60539753, 6590018.91740243, 6572664.82742798, 6563443.12055786, 6566018.6729966, 6574772.10223999, 6588601.09738829, 6587866.70828898, 6594422.27412303, 6596058.32814888, 6582824.48242667, 6566650.62627534, 6565481.01004849, 6550099.07408309, 6538111.98010196, 6533626.63136806, 6526996.87588149, 6526889.99320914, 6547821.454126, 6573402.32788877))"
332;053;GAP;HAUTES ALPES;32398;2329;366;6079;24651;65823;14490;3058;1830;70670;93586;249457;834;05;;list(c(923043.794940778, 946846.66213321, 958192.868595725, 960458.748601587, 955270.793133213, 908472.739328397, 923043.794940778, 6422210.07653362, 6432929.88687068, 6419212.733793, 6368255.05049606, 6366558.07415452, 6376507.88514578, 6422210.07653362))
333;572;METZ;MOSELLE;60904;10317;6833;10927;13206;102187;13816;4001;1384;1434;39231;162053;40;57;;list(c(904990.180469012, 928668.427776873, 964327.882375713, 965335.82805438, 932951.000788324, 921350.972540475, 908442.179822664, 904990.180469012, 6880047.38417663, 6908559.860104, 6914561.71268528, 6893625.13401862, 6870979.83790436, 6870930.27309123, 6876302.79450235, 6880047.38417663))
334;051;BRIANCON;HAUTES ALPES;5155;693;97;434;3153;9532;29380;257;8;63522;61282;163981;31;05;;"list(c(969431.871739863, 1000033.45862987, 1011566.68463799, 1012212.49067108, 1027190.78294853, 1021850.670122, 1024393.71942278, 1011216.59019916, 1002040.81242497, 996038.927645047, 985376.067055171, 995677.033091534, 1005234.38013232, 1016118.53330231, 1019251.51534393, 1012919.60480147, 1011853.41088799, 1011636.3580997, 958192.868595725, 946846.66213321, 969431.871739863, 6492188.82512509, 6518875.00348942, 6512353.3074018, 6497398.32803534, 6487327.99596199, 6477098.31876725, 6470443.58165845, 
6464359.69504524, 6455826.48864986, 6458225.79521958, 6452126.22026735, 6431748.08267047, 6424284.37646851, 6423865.78721105, 6407271.61446077, 6402902.77348072, 6400637.18806743, 6400629.30887027, 6419212.733793, 6432929.88687068, 6492188.82512509))"
335;831;BRIGNOLES;VAR;34220;2809;136;1643;9765;48573;1147;23457;10680;11462;102080;197399;26;83;;list(c(948148.641528403, 949565.958637942, 983830.085038424, 977118.402359926, 920984.46861048, 919442.296402507, 926291.652744684, 948148.641528403, 6295271.12408316, 6294433.58171573, 6234480.78056278, 6232719.12134293, 6253507.87612492, 6259721.63941388, 6286221.87058665, 6295271.12408316))
336;254;PONTARLIER;DOUBS;25033;2927;379;7235;3215;38789;26084;0;0;34329;29162;128364;280;25;;list(c(937287.132830407, 928809.446087219, 948487.549637803, 987502.354927357, 988023.865451065, 983512.301417465, 976014.791010821, 965725.877917469, 961749.066520162, 949684.023922778, 946232.054077495, 941571.058079956, 937287.132830407, 6624064.39949003, 6659461.48507649, 6675091.93501817, 6679041.15496766, 6678830.12325574, 6674269.67440551, 6661677.18215529, 6658543.28552819, 6634205.58156855, 6624735.91800528, 6619738.26034116, 6621400.26969575, 6624064.39949003))
337;541;CHATEAU SALINS;MEURTHE;37729;5326;3017;10218;9394;65684;13455;1336;637;184;27382;108678;1208;54;;list(c(973548.960367375, 948496.862382901, 932951.000788324, 965335.82805438, 978246.951521858, 973548.960367375, 6853656.08352971, 6849707.9609803, 6870979.83790436, 6893625.13401862, 6877501.60979829, 6853656.08352971))
338;544;SARREBOURG;MEURTHE;24947;4452;878;4008;6892;41177;14834;45;355;795;55520;112726;72;54;;list(c(978246.951521858, 1005342.83490058, 1009921.50182053, 983907.990437309, 973548.960367375, 978246.951521858, 6877501.60979829, 6875807.94722165, 6830379.29107661, 6831749.48924874, 6853656.08352971, 6877501.60979829))
339;573;SARREGUEMINES;MOSELLE;44309;8823;3040;6067;13065;75304;16586;84;707;1133;56068;149882;169;57;;"list(c(965335.82805438, 964327.882375713, 964337.087616747, 972600.182789737, 985420.372863059, 993047.1061585, 996089.695222984, 1009707.8755331, 1023984.92811744, 1030596.12836061, 1029564.89737544, 1005342.83490058, 978246.951521858, 965335.82805438, 6893625.13401862, 6914561.71268528, 6914585.64328138, 6902440.38971972, 6909340.57514868, 6906739.23112611, 6897854.3880029, 6900574.59129695, 6907406.67154327, 6901238.91327437, 6889955.89237119, 6875807.94722165, 6877501.60979829, 6893625.13401862
))"
340;543;NANCY;MEURTHE;46886;7059;3993;5815;13462;77215;15200;7344;1112;1498;42933;145302;63;54;;list(c(921350.972540475, 932951.000788324, 948496.862382901, 939694.304397422, 925213.54719996, 921350.972540475, 6870930.27309123, 6870979.83790436, 6849707.9609803, 6825433.74253288, 6826188.67120368, 6870930.27309123))
341;542;LUNEVILLE;MEURTHE;39646;5293;2957;4596;14424;66916;16243;2080;0;849;39398;125486;43;54;;list(c(948496.862382901, 973548.960367375, 983907.990437309, 967598.913637813, 953467.45042273, 939694.304397422, 948496.862382901, 6849707.9609803, 6853656.08352971, 6831749.48924874, 6814665.17027423, 6814550.23091819, 6825433.74253288, 6849707.9609803))
342;881;EPINAL;VOSGES;38372;8784;1473;4880;14231;67740;16938;460;757;3530;57623;147048;19;88;;list(c(953467.45042273, 967598.913637813, 980735.179471421, 932836.13792965, 953467.45042273, 6814550.23091819, 6814665.17027423, 6788390.10952691, 6771236.51732129, 6814550.23091819))
343;251;BAUME LES DAMES;DOUBS;45286;3845;1204;9010;5603;64948;19375;1892;283;17282;43582;147362;254;25;;list(c(933270.240495217, 953052.055496909, 964224.281324919, 987502.354927357, 948487.549637803, 933270.240495217, 6709406.10266564, 6719420.65729984, 6716512.79380872, 6679041.15496766, 6675091.93501817, 6709406.10266564))
344;043;DIGNE;BASSES ALPES;31352;3673;269;5401;20089;60784;3343;5750;655;112520;56022;239074;0;04;;list(c(941908.673845336, 955270.793133213, 960458.748601587, 961916.074444036, 990437.041646919, 950945.695642352, 941908.673845336, 6330107.83199113, 6366558.07415452, 6368255.05049606, 6367828.58281481, 6340338.23611946, 6311288.94124545, 6330107.83199113))
345;832;DRAGUIGNAN;VAR;35318;2923;233;1637;18832;58943;3932;23512;22360;59700;107837;276284;36;83;;list(c(949565.958637942, 985520.763817444, 1005259.42183734, 1003427.42740139, 997452.681283148, 997508.484352509, 985555.710310217, 983830.085038424, 949565.958637942, 6294433.58171573, 6294189.45978313, 6265569.27071372, 6265385.08155548, 6253438.09502426, 6239867.41254821, 6234933.71670647, 6234480.78056278, 6294433.58171573))
346;253;MONTBELIARD;DOUBS;24114;3361;644;4928;3244;36291;23718;264;482;16780;30226;107761;229;25;;list(c(964224.281324919, 973567.206127154, 1011980.77789636, 1019338.40256449, 1014541.20464636, 1010779.78916535, 999746.673144888, 996884.703476348, 992708.984977278, 999091.313667033, 988023.865451065, 987502.354927357, 964224.281324919, 6716512.79380872, 6728731.29786729, 6723184.93613082, 6712949.78512721, 6713052.08943164, 6719527.8075698, 6717998.53231616, 6711072.51337944, 6702463.51643593, 6690017.49222924, 6678830.12325574, 6679041.15496766, 6716512.79380872))
347;884;REMIRMONT;VOSGES;8523;4988;423;373;5298;19605;23019;0;58;11143;33728;87553;211;88;;list(c(932836.13792965, 980735.179471421, 997346.066930215, 998693.142558477, 996527.950932055, 976455.811725479, 943330.997683791, 928821.792674589, 932836.13792965, 6771236.51732129, 6788390.10952691, 6775388.09620801, 6769910.49891562, 6764843.22243421, 6753831.88232641, 6756973.63274456, 6766782.38159316, 6771236.51732129))
348;885;SAINT DIE;VOSGES;18102;9818;1281;1030;9450;39681;23746;41;78;11035;63521;138102;125;88;;list(c(980735.179471421, 967598.913637813, 983907.990437309, 1009921.50182053, 1012047.39668719, 1009087.33593768, 997346.066930215, 980735.179471421, 6788390.10952691, 6814665.17027423, 6831749.48924874, 6830379.29107661, 6829216.12564894, 6797044.831063, 6775388.09620801, 6788390.10952691))
349;702;LURE;HAUTE SAONE;42012;8962;2130;4686;11023;68813;28500;2000;797;6576;78231;184917;0;70;;list(c(943330.997683791, 976455.811725479, 973567.206127154, 964224.281324919, 953052.055496909, 943330.997683791, 6756973.63274456, 6753831.88232641, 6728731.29786729, 6716512.79380872, 6719420.65729984, 6756973.63274456))
350;042;CASTELLANE;BASSES ALPES;17985;976;64;1871;8071;28967;4155;997;1158;64070;30180;129527;0;04;;list(c(950945.695642352, 990437.041646919, 1018450.13219561, 985520.763817444, 949565.958637942, 948148.641528403, 950945.695642352, 6311288.94124545, 6340338.23611946, 6335549.99595518, 6294189.45978313, 6294433.58171573, 6295271.12408316, 6311288.94124545))
351;052;EMBRUN;HAUTES ALPES;7492;705;212;2196;6148;16753;20120;1873;70;62454;44253;145523;191;05;;list(c(958192.868595725, 1011636.3580997, 961916.074444036, 960458.748601587, 958192.868595725, 6419212.733793, 6400629.30887027, 6367828.58281481, 6368255.05049606, 6419212.733793))
352;682;BELFORT;HAUT RHIN;19543;7385;1150;2709;5233;36020;25480;685;952;11662;51258;126057;327;68;;list(c(996527.950932055, 1011980.77789636, 973567.206127154, 976455.811725479, 996527.950932055, 6764843.22243421, 6723184.93613082, 6728731.29786729, 6753831.88232641, 6764843.22243421))
353;041;BARCELONNETTE;BASSES ALPES;5034;305;76;1592;3725;10732;21155;162;6;50775;32324;115154;0;04;;list(c(961916.074444036, 1011636.3580997, 1011853.41088799, 1006151.20375182, 1013073.61582925, 1009694.48807776, 1019132.57420215, 1053703.59067891, 1068941.83654143, 1074505.98107728, 1018450.13219561, 990437.041646919, 961916.074444036, 6367828.58281481, 6400629.30887027, 6400637.18806743, 6388520.40785706, 6379032.01425063, 6370097.47486399, 6358157.96468939, 6344873.66851539, 6349745.97202984, 6345157.62719844, 6335549.99595518, 6340338.23611946, 6367828.58281481))
354;203;CALVI;CORSE;5132;63;165;15;4397;9772;165;620;3333;35229;51174;100293;29;20;;list(c(1200572.97564403, 1166246.575263, 1159332.30723451, 1165746.67962201, 1165877.38261005, 1185571.86955056, 1193923.22966451, 1195685.28660094, 1200572.97564403, 6179036.83131744, 6150392.8212086, 6158612.59623463, 6162871.23979715, 6173812.17216782, 6189011.07820771, 6190488.37966002, 6192833.90302559, 6179036.83131744))
355;681;MULHOUSE;HAUT RHIN;38645;6365;2475;4719;6139;58343;14076;1527;1325;1447;38544;115262;101;68;;list(c(1011980.77789636, 996527.950932055, 998693.142558477, 1042238.50733905, 1039184.13107444, 1039363.16718539, 1044887.03527419, 1039284.78730705, 1030440.02242889, 1019338.40256449, 1011980.77789636, 6723184.93613082, 6764843.22243421, 6769910.49891562, 6766889.41118841, 6752860.46930117, 6738642.68842758, 6732483.86952049, 6720845.57642787, 6712713.0336907, 6712949.78512721, 6723184.93613082))
356;833;GRASSE;VAR;15035;1514;151;815;8307;25822;1360;11390;8856;41281;31149;119858;0;83;;"list(c(985520.763817444, 1018450.13219561, 1074505.98107728, 1077494.13145483, 1073140.26742421, 1061620.57600284, 1063270.71472016, 1036149.42776268, 1032827.19099138, 1021500.28750084, 1018233.1281393, 1015002.93533113, 1005259.42183734, 985520.763817444, 6294189.45978313, 6335549.99595518, 6345157.62719844, 6342693.51717183, 6330477.43489033, 6318750.57919988, 6308610.72085407, 6293138.37699146, 6285038.77383364, 6280114.59598313, 6272507.46954971, 6266548.88588806, 6265569.27071372, 6294189.45978313
))"
357;671;SAVERNE;BAS RHIN;30208;9608;2859;5194;2786;50655;14767;2154;1945;1183;43318;114022;0;67;;list(c(1005342.83490058, 1029564.89737544, 1046321.66125127, 1025225.77010551, 1012047.39668719, 1009921.50182053, 1005342.83490058, 6875807.94722165, 6889955.89237119, 6868291.19080425, 6831090.48430524, 6829216.12564894, 6830379.29107661, 6875807.94722165))
358;683;COLMAR;HAUT RHIN;35826;11971;2402;7517;6035;63751;19009;9349;511;13030;63803;169453;290;68;;list(c(997346.066930215, 1009087.33593768, 1042758.54761342, 1040416.29799694, 1044139.19693601, 1042238.50733905, 998693.142558477, 997346.066930215, 6775388.09620801, 6797044.831063, 6794883.21199758, 6789867.82573154, 6775619.39780154, 6766889.41118841, 6769910.49891562, 6775388.09620801))
359;202;BASTIA;CORSE;22707;747;612;945;9901;34912;228;8462;20912;55396;16299;136209;805;20;;list(c(1200572.97564403, 1195685.28660094, 1201676.59230404, 1218188.60498088, 1215955.81495055, 1219176.08311984, 1227058.41140756, 1229858.88669966, 1228676.09700585, 1236751.47094546, 1241312.73327952, 1241345.57104914, 1200572.97564403, 6179036.83131744, 6192833.90302559, 6200809.09793917, 6198258.42790367, 6213123.20920932, 6223550.93376809, 6231130.32253007, 6214701.47222204, 6195700.32285116, 6183018.49925135, 6154154.36934075, 6153255.53300561, 6179036.83131744))
360;673;STRASBOURG;BAS RHIN;34611;17648;7844;5777;2530;68410;15933;3264;1210;5536;50123;144476;0;67;;list(c(1025225.77010551, 1046321.66125127, 1069167.13737954, 1056332.18537508, 1050154.61345983, 1051036.00463021, 1025225.77010551, 6831090.48430524, 6868291.19080425, 6863049.48501049, 6848791.50383211, 6821395.41707844, 6814680.27308146, 6831090.48430524))
361;672;SCHLESTADT;BAS RHIN;22962;10006;3753;3331;2228;42280;17344;5699;831;6608;43665;116427;0;67;;list(c(1051036.00463021, 1051248.38013421, 1042758.54761342, 1009087.33593768, 1012047.39668719, 1025225.77010551, 1051036.00463021, 6814680.27308146, 6813062.22636312, 6794883.21199758, 6797044.831063, 6829216.12564894, 6831090.48430524, 6814680.27308146))
362;201;AJACCIO;CORSE;16071;1684;311;220;5511;23797;722;1499;3007;81396;94981;205402;130;20;;list(c(1210922.31460489, 1177535.18093458, 1182096.57746455, 1166111.82885645, 1164174.18614337, 1175709.52921264, 1172053.96531481, 1163200.82287019, 1160587.08246344, 1160791.82518064, 1210922.31460489, 6108595.07993149, 6089163.36313405, 6106415.52597061, 6106836.54659648, 6112384.62965354, 6121721.90605983, 6129365.41640068, 6130808.58255667, 6141574.51852836, 6141676.7382019, 6108595.07993149))
363;204;CORTE;CORSE;16820;337;230;45;11348;28780;355;1618;11165;46186;160403;248507;200;20;;list(c(1160791.82518064, 1169796.62937725, 1166246.575263, 1200572.97564403, 1241345.57104914, 1242054.61613784, 1232295.82697129, 1232193.05293765, 1210922.31460489, 1160791.82518064, 6141676.7382019, 6146172.46902826, 6150392.8212086, 6179036.83131744, 6153255.53300561, 6133847.53129456, 6116512.92036327, 6107102.38692943, 6108595.07993149, 6141676.7382019))
